//MAP CONVERTED BY dmm2tgm.py THIS HEADER COMMENT PREVENTS RECONVERSION, DO NOT REMOVE
"a" = (
/turf/template_noop,
/area/template_noop)
"b" = (
/obj/effect/decal/cleanable/blood/tracks{
	dir = 1
	},
/obj/effect/decal/cleanable/blood/tracks{
	dir = 1
	},
/obj/effect/decal/cleanable/blood/bubblegum{
	icon_state = "drip4"
	},
/turf/open/misc/asteroid,
/area/template_noop)
"e" = (
/obj/effect/decal/cleanable/blood/tracks{
	dir = 1
	},
/obj/effect/decal/cleanable/blood/bubblegum{
	icon_state = "drip1"
	},
/turf/open/misc/asteroid,
/area/template_noop)
"f" = (
/turf/open/misc/asteroid,
/area/template_noop)
"h" = (
/obj/effect/decal/cleanable/blood/tracks{
	dir = 1
	},
/obj/effect/decal/cleanable/blood/bubblegum{
	icon_state = "drip3"
	},
/turf/open/misc/asteroid,
/area/template_noop)
"n" = (
/obj/effect/decal/cleanable/blood/tracks{
	dir = 10
	},
/turf/open/misc/asteroid,
/area/template_noop)
"p" = (
/obj/effect/mob_spawn/corpse/human,
/obj/effect/decal/cleanable/blood/bubblegum{
	icon_state = "floor2"
	},
/turf/open/misc/asteroid,
/area/template_noop)
"s" = (
/obj/effect/decal/cleanable/blood/bubblegum{
	icon_state = "gib3-old"
	},
/turf/open/misc/asteroid,
/area/template_noop)
"u" = (
/obj/effect/decal/cleanable/blood/tracks{
	dir = 5
	},
/turf/open/misc/asteroid,
/area/template_noop)
"x" = (
/obj/effect/decal/cleanable/blood/tracks{
	dir = 1
	},
/obj/effect/decal/cleanable/blood/bubblegum{
	icon_state = "armorblood"
	},
/turf/open/misc/asteroid,
/area/template_noop)
"E" = (
/turf/closed/mineral/random,
/area/template_noop)
"F" = (
/obj/effect/decal/cleanable/blood/bubblegum{
	icon_state = "armorblood"
	},
/obj/effect/decal/cleanable/blood/bubblegum{
	icon_state = "armorblood"
	},
/turf/closed/mineral/random,
/area/template_noop)
"I" = (
/obj/structure/sign/nanotrasen,
/obj/structure/marker_beacon/indigo,
/turf/closed/wall,
/area/template_noop)
"J" = (
/obj/effect/decal/cleanable/blood/tracks{
	dir = 1
	},
/turf/open/misc/asteroid,
/area/template_noop)
"T" = (
/obj/effect/decal/cleanable/blood,
/turf/open/misc/asteroid,
/area/template_noop)
"U" = (
/obj/structure/lattice/catwalk,
/obj/structure/marker_beacon/indigo,
/turf/open/space/basic,
/area/template_noop)
"Y" = (
/obj/effect/decal/cleanable/blood/tracks{
	dir = 8
	},
/turf/open/misc/asteroid,
/area/template_noop)

(1,1,1) = {"
a
a
a
a
a
a
a
a
a
a
a
a
a
a
a
a
a
a
a
a
a
a
a
a
a
a
a
a
a
a
a
a
a
a
a
a
a
a
a
a
a
a
a
a
a
a
a
a
a
a
"}
(2,1,1) = {"
a
a
a
a
a
a
a
a
a
a
a
a
a
a
a
a
a
a
a
a
a
a
a
a
a
a
a
a
a
a
a
a
a
a
a
a
a
a
a
a
a
a
a
a
a
a
a
a
a
a
"}
(3,1,1) = {"
a
a
a
a
a
a
a
a
a
a
a
a
a
a
a
a
a
a
a
a
a
a
a
a
a
a
a
a
a
a
a
a
a
a
a
a
a
a
a
a
a
a
a
a
a
a
a
a
a
a
"}
(4,1,1) = {"
a
a
a
a
a
a
a
a
a
a
a
a
a
a
a
a
a
a
a
a
a
a
a
a
U
a
a
a
a
a
a
a
a
a
a
a
a
a
a
a
a
a
a
a
a
a
a
a
a
a
"}
(5,1,1) = {"
a
a
a
a
a
a
a
a
a
a
a
a
a
a
a
a
a
a
a
a
a
a
f
f
I
f
f
a
a
a
a
a
a
a
a
a
a
a
a
a
a
a
a
a
a
a
a
a
a
a
"}
(6,1,1) = {"
a
a
a
a
a
a
a
a
a
a
a
a
a
a
a
E
E
E
E
E
E
E
f
f
f
f
f
f
u
e
J
b
h
x
n
f
E
E
a
a
a
a
a
a
a
a
a
a
a
a
"}
(7,1,1) = {"
a
a
a
a
a
a
a
a
a
a
a
a
E
E
E
E
E
E
E
E
E
E
E
E
f
f
f
f
f
f
T
f
f
f
Y
E
E
E
E
a
a
a
a
a
a
a
a
a
a
a
"}
(8,1,1) = {"
a
a
a
a
a
a
a
a
a
a
a
a
E
E
E
E
E
E
E
E
E
E
E
E
E
E
E
E
F
E
E
E
E
E
Y
E
E
E
E
E
E
a
a
a
a
a
a
a
a
a
"}
(9,1,1) = {"
a
a
a
a
a
a
a
a
a
a
f
E
E
E
E
E
E
E
E
E
E
E
E
E
E
E
E
E
E
E
E
E
E
E
Y
E
E
E
E
E
E
a
a
a
a
a
a
a
a
a
"}
(10,1,1) = {"
a
a
a
a
a
a
a
f
f
f
f
E
E
E
E
E
E
E
E
E
E
E
E
E
E
E
E
E
E
E
E
E
E
E
p
f
f
s
f
f
f
f
f
a
a
a
a
a
a
a
"}
(11,1,1) = {"
a
a
a
a
a
f
f
f
E
E
E
E
E
E
E
E
E
E
E
E
E
E
E
E
E
E
E
E
E
E
E
E
E
E
E
E
E
E
E
E
f
f
f
a
a
a
a
a
a
a
"}
(12,1,1) = {"
a
a
a
a
a
f
f
f
E
E
E
E
E
E
E
E
E
E
E
E
E
E
E
E
E
E
E
E
E
E
E
E
E
E
E
E
E
E
E
E
f
f
a
a
a
a
a
a
a
a
"}
(13,1,1) = {"
a
a
a
a
f
f
E
E
E
E
E
E
E
E
E
E
E
E
E
E
E
E
E
E
E
E
E
E
E
E
E
E
E
E
E
E
E
E
E
E
f
f
a
a
a
a
a
a
a
a
"}
(14,1,1) = {"
a
a
a
a
f
f
E
E
E
E
E
E
E
E
E
E
E
E
E
E
E
E
E
E
E
E
E
E
E
E
E
E
E
E
E
E
E
E
E
E
f
f
f
f
a
a
a
a
a
a
"}
(15,1,1) = {"
a
a
a
a
f
f
E
E
E
E
E
E
E
E
E
E
E
E
E
E
E
E
E
E
E
E
E
E
E
E
E
E
E
E
E
E
E
E
E
E
f
f
f
f
a
a
a
a
a
a
"}
(16,1,1) = {"
a
a
a
a
f
f
E
E
E
E
E
E
E
E
E
E
E
E
E
E
E
E
E
E
E
E
E
E
E
E
E
E
E
E
E
E
E
E
E
E
f
E
E
E
a
a
a
a
a
a
"}
(17,1,1) = {"
a
a
a
a
f
f
E
E
E
E
E
E
E
E
E
E
E
E
E
E
E
E
E
E
E
E
E
E
E
E
E
E
E
E
E
E
E
E
E
E
f
E
E
E
a
a
a
a
a
a
"}
(18,1,1) = {"
a
a
a
a
a
f
E
E
E
E
E
E
E
E
E
E
E
E
E
E
E
E
E
E
E
E
E
E
E
E
E
E
E
E
E
E
E
E
E
E
f
E
E
E
E
E
a
a
a
a
"}
(19,1,1) = {"
a
a
a
a
a
f
E
E
E
E
E
E
E
E
E
E
E
E
E
E
E
E
E
E
E
E
E
E
E
E
E
E
E
E
E
E
E
E
E
E
f
f
E
E
E
E
a
a
a
a
"}
(20,1,1) = {"
a
a
a
a
a
a
E
E
E
E
E
E
E
E
E
E
E
E
E
E
E
E
E
E
E
E
E
E
E
E
E
E
E
E
E
E
E
E
E
E
E
f
E
E
E
E
a
a
a
a
"}
(21,1,1) = {"
a
a
a
a
a
a
a
E
E
E
E
E
E
E
E
E
E
E
E
E
E
E
E
E
E
E
E
E
E
E
E
E
E
E
E
E
E
E
E
E
E
f
f
E
E
E
a
a
a
a
"}
(22,1,1) = {"
a
a
a
a
a
a
a
E
E
E
E
E
E
E
E
E
E
E
E
E
E
E
E
E
E
E
E
E
E
E
E
E
E
E
E
E
E
E
E
E
E
E
f
f
E
E
E
f
a
a
"}
(23,1,1) = {"
a
a
a
a
a
a
a
E
E
E
E
E
E
E
E
E
E
E
E
E
E
E
E
E
E
E
E
E
E
E
E
E
E
E
E
E
E
E
E
E
E
E
E
f
E
E
E
f
a
a
"}
(24,1,1) = {"
a
a
a
a
a
a
a
E
E
E
E
E
E
E
E
E
E
E
E
E
E
E
E
E
E
E
E
E
E
E
E
E
E
E
E
E
E
E
E
E
E
E
E
f
f
f
f
f
f
a
"}
(25,1,1) = {"
a
a
a
a
a
a
a
a
E
E
E
E
E
E
E
E
E
E
E
E
E
E
E
E
E
E
E
E
E
E
E
E
E
E
E
E
E
E
E
E
E
E
E
E
f
E
E
f
f
a
"}
(26,1,1) = {"
a
a
a
a
a
a
a
a
E
E
E
E
E
E
E
E
E
E
E
E
E
E
E
E
E
E
E
E
E
E
E
E
E
E
E
E
E
E
E
E
E
E
E
E
f
E
E
f
a
a
"}
(27,1,1) = {"
a
a
a
a
a
a
a
a
E
E
E
E
E
E
E
E
E
E
E
E
E
E
E
E
E
E
E
E
E
E
E
E
E
E
E
E
E
E
E
E
E
E
E
E
f
E
E
a
a
a
"}
(28,1,1) = {"
a
a
a
a
a
a
a
U
I
E
E
E
E
E
E
E
E
E
E
E
E
E
E
E
E
E
E
E
E
E
E
E
E
E
E
E
E
E
E
E
E
E
E
E
f
E
a
a
a
a
"}
(29,1,1) = {"
a
a
a
a
a
a
a
a
E
E
E
E
E
E
E
E
E
E
E
E
E
E
E
E
E
E
E
E
E
E
E
E
E
E
E
E
E
E
E
E
E
E
E
E
f
I
U
a
a
a
"}
(30,1,1) = {"
a
a
a
a
a
a
a
a
E
E
E
E
E
E
E
E
E
E
E
E
E
E
E
E
E
E
E
E
E
E
E
E
E
E
E
E
E
E
E
E
E
E
E
E
f
f
a
a
a
a
"}
(31,1,1) = {"
a
a
a
a
a
a
a
a
f
f
E
E
E
E
E
E
E
E
E
E
E
E
E
E
E
E
E
E
E
E
E
E
E
E
E
E
E
E
E
E
E
E
E
E
f
f
a
a
a
a
"}
(32,1,1) = {"
a
a
a
a
a
a
a
f
f
f
E
E
E
E
E
E
E
E
E
E
E
E
E
E
E
E
E
E
E
E
E
E
E
E
E
E
E
E
E
E
E
E
E
E
f
f
a
a
a
a
"}
(33,1,1) = {"
a
a
a
a
a
a
a
f
f
f
f
E
E
E
E
E
E
E
E
E
E
E
E
E
E
E
E
E
E
E
E
E
E
E
E
E
E
E
E
E
E
E
E
E
f
f
a
a
a
a
"}
(34,1,1) = {"
a
a
a
a
a
a
a
a
f
f
f
E
E
E
E
E
E
E
E
E
E
E
E
E
E
E
E
E
E
E
E
E
E
E
E
E
E
E
E
E
E
E
E
f
f
f
a
a
a
a
"}
(35,1,1) = {"
a
a
a
a
a
a
a
a
f
f
f
f
E
E
E
E
E
E
E
E
E
E
E
E
E
E
E
E
E
E
E
E
E
E
E
E
E
E
E
E
E
f
f
f
f
f
a
a
a
a
"}
(36,1,1) = {"
a
a
a
a
a
a
a
a
a
f
f
f
f
E
E
E
E
f
E
E
E
E
E
E
E
E
I
E
E
E
E
E
E
E
E
E
E
E
E
E
E
f
E
E
f
f
a
a
a
a
"}
(37,1,1) = {"
a
a
a
a
a
a
a
a
a
f
f
f
f
E
E
E
E
f
E
E
E
E
E
E
E
a
U
a
a
E
E
E
E
E
E
E
E
E
E
E
E
f
E
E
E
f
a
a
a
a
"}
(38,1,1) = {"
a
a
a
a
a
a
a
a
a
f
f
f
f
f
E
E
E
f
f
E
E
E
E
a
a
a
a
a
a
a
a
E
E
E
E
E
E
E
E
E
E
f
E
E
a
a
a
a
a
a
"}
(39,1,1) = {"
a
a
a
a
a
a
a
a
a
a
a
f
f
f
f
f
f
f
f
E
E
E
E
a
a
a
a
a
a
a
a
a
E
E
E
E
E
E
E
E
E
f
E
a
a
a
a
a
a
a
"}
(40,1,1) = {"
a
a
a
a
a
a
a
a
a
a
a
a
f
f
f
f
f
f
f
f
f
f
f
a
a
a
a
a
a
a
a
a
a
a
a
E
E
E
E
E
f
f
a
a
a
a
a
a
a
a
"}
(41,1,1) = {"
a
a
a
a
a
a
a
a
a
a
a
a
a
a
a
f
f
f
f
f
a
a
a
a
a
a
a
a
a
a
a
a
a
a
a
a
E
E
E
E
f
f
a
a
a
a
a
a
a
a
"}
(42,1,1) = {"
a
a
a
a
a
a
a
a
a
a
a
a
a
a
a
a
f
f
f
a
a
a
a
a
a
a
a
a
a
a
a
a
a
a
a
a
a
f
f
f
f
a
a
a
a
a
a
a
a
a
"}
(43,1,1) = {"
a
a
a
a
a
a
a
a
a
a
a
a
a
a
a
a
a
a
a
a
a
a
a
a
a
a
a
a
a
a
a
a
a
a
a
a
a
a
a
a
a
a
a
a
a
a
a
a
a
a
"}
(44,1,1) = {"
a
a
a
a
a
a
a
a
a
a
a
a
a
a
a
a
a
a
a
a
a
a
a
a
a
a
a
a
a
a
a
a
a
a
a
a
a
a
a
a
a
a
a
a
a
a
a
a
a
a
"}
(45,1,1) = {"
a
a
a
a
a
a
a
a
a
a
a
a
a
a
a
a
a
a
a
a
a
a
a
a
a
a
a
a
a
a
a
a
a
a
a
a
a
a
a
a
a
a
a
a
a
a
a
a
a
a
"}
(46,1,1) = {"
a
a
a
a
a
a
a
a
a
a
a
a
a
a
a
a
a
a
a
a
a
a
a
a
a
a
a
a
a
a
a
a
a
a
a
a
a
a
a
a
a
a
a
a
a
a
a
a
a
a
"}
(47,1,1) = {"
a
a
a
a
a
a
a
a
a
a
a
a
a
a
a
a
a
a
a
a
a
a
a
a
a
a
a
a
a
a
a
a
a
a
a
a
a
a
a
a
a
a
a
a
a
a
a
a
a
a
"}
(48,1,1) = {"
a
a
a
a
a
a
a
a
a
a
a
a
a
a
a
a
a
a
a
a
a
a
a
a
a
a
a
a
a
a
a
a
a
a
a
a
a
a
a
a
a
a
a
a
a
a
a
a
a
a
"}
(49,1,1) = {"
a
a
a
a
a
a
a
a
a
a
a
a
a
a
a
a
a
a
a
a
a
a
a
a
a
a
a
a
a
a
a
a
a
a
a
a
a
a
a
a
a
a
a
a
a
a
a
a
a
a
"}
(50,1,1) = {"
a
a
a
a
a
a
a
a
a
a
a
a
a
a
a
a
a
a
a
a
a
a
a
a
a
a
a
a
a
a
a
a
a
a
a
a
a
a
a
a
a
a
a
a
a
a
a
a
a
a
"}
