//MAP CONVERTED BY dmm2tgm.py THIS HEADER COMMENT PREVENTS RECONVERSION, DO NOT REMOVE
"aE" = (
/obj/effect/turf_decal/trimline/dark/filled/warning,
/obj/structure/sign/painting/library{
	pixel_y = -32
	},
/turf/open/floor/iron/large,
/area/ruin/space/has_grav/hobbystation/central)
"ba" = (
/obj/structure/tank_holder/extinguisher,
/obj/effect/decal/cleanable/dirt/dust,
/turf/open/floor/iron/kitchen,
/area/ruin/space/has_grav/hobbystation/commons/kitchen)
"dg" = (
/obj/effect/turf_decal/trimline/dark/filled/warning{
	dir = 8
	},
/obj/structure/sign/painting/library{
	pixel_x = -31
	},
/obj/effect/decal/cleanable/dirt/dust,
/turf/open/floor/iron/large,
/area/ruin/space/has_grav/hobbystation/central)
"dM" = (
/obj/effect/decal/cleanable/blood/tracks{
	dir = 1
	},
/obj/effect/decal/cleanable/blood/bubblegum{
	icon_state = "armorblood"
	},
/turf/open/misc/asteroid,
/area/template_noop)
"dX" = (
/obj/structure/closet/crate/freezer,
/obj/item/food/monkeycube,
/obj/item/food/monkeycube,
/obj/item/food/monkeycube,
/obj/item/clothing/head/utility/chefhat,
/obj/item/clothing/under/rank/civilian/chef,
/obj/effect/decal/cleanable/dirt/dust,
/obj/item/mop,
/turf/open/floor/iron/kitchen,
/area/ruin/space/has_grav/hobbystation/commons/kitchen)
"dY" = (
/obj/effect/decal/cleanable/dirt/dust,
/obj/effect/decal/cleanable/dirt/dust,
/turf/open/floor/iron/checker,
/area/ruin/space/has_grav/hobbystation/recreational)
"eg" = (
/obj/effect/decal/cleanable/blood/tracks{
	dir = 1
	},
/obj/effect/decal/cleanable/blood/bubblegum{
	icon_state = "drip3"
	},
/turf/open/misc/asteroid,
/area/template_noop)
"er" = (
/obj/effect/turf_decal/trimline/dark/filled/warning{
	dir = 10
	},
/obj/effect/decal/cleanable/dirt/dust,
/turf/open/floor/iron/large,
/area/ruin/space/has_grav/hobbystation/central)
"fu" = (
/obj/structure/sink/kitchen/directional/south,
/obj/effect/decal/cleanable/dirt/dust,
/turf/open/floor/iron/kitchen,
/area/ruin/space/has_grav/hobbystation/commons/kitchen)
"fJ" = (
/obj/effect/decal/cleanable/dirt/dust,
/turf/closed/wall/r_wall,
/area/ruin/space/has_grav/hobbystation/recreational)
"fK" = (
/obj/structure/table,
/obj/item/paper/fluff/ruins/hobbystation/infoholodeck,
/obj/effect/decal/cleanable/dirt/dust,
/obj/structure/window/reinforced{
	dir = 1
	},
/turf/open/floor/iron/dark/side{
	dir = 8
	},
/area/ruin/space/has_grav/hobbystation/recreational)
"fU" = (
/turf/open/floor/iron/checker,
/area/ruin/space/has_grav/hobbystation/recreational)
"gc" = (
/obj/structure/window/reinforced{
	dir = 8
	},
/turf/open/floor/iron/checker,
/area/ruin/space/has_grav/hobbystation/recreational)
"gf" = (
/obj/effect/turf_decal/trimline/dark/filled/warning{
	dir = 6
	},
/obj/effect/decal/cleanable/dirt/dust,
/turf/open/floor/iron/large,
/area/ruin/space/has_grav/hobbystation/central)
"gG" = (
/obj/structure/table/reinforced,
/obj/item/paper/fluff/ruins/hobbystation/infofluff,
/turf/open/floor/iron/dark/textured_corner{
	dir = 4
	},
/area/ruin/space/has_grav/hobbystation/commons)
"gJ" = (
/obj/structure/table/reinforced,
/obj/item/reagent_containers/condiment/saltshaker{
	pixel_y = 6;
	pixel_x = -5
	},
/obj/item/reagent_containers/condiment/peppermill{
	pixel_y = 6;
	pixel_x = 5
	},
/turf/open/floor/iron/cafeteria,
/area/ruin/space/has_grav/hobbystation/central)
"gW" = (
/turf/closed/wall/r_wall,
/area/ruin/space/has_grav/hobbystation/commons)
"hb" = (
/obj/effect/decal/cleanable/ash/crematorium,
/turf/open/floor/iron/cafeteria,
/area/ruin/space/has_grav/hobbystation/central)
"hQ" = (
/obj/effect/decal/cleanable/dirt/dust,
/obj/structure/window/reinforced{
	dir = 4
	},
/turf/open/floor/iron/checker,
/area/ruin/space/has_grav/hobbystation/recreational)
"iQ" = (
/turf/closed/wall,
/area/ruin/space/has_grav/hobbystation/commons/kitchen)
"ja" = (
/obj/structure/table/reinforced,
/obj/item/paper/fluff/ruins/hobbystation/infofluff,
/obj/effect/decal/cleanable/dirt/dust,
/turf/open/floor/iron/dark/textured_corner,
/area/ruin/space/has_grav/hobbystation/commons)
"jb" = (
/obj/effect/decal/cleanable/dirt/dust,
/obj/structure/window/reinforced{
	dir = 1
	},
/turf/open/floor/iron/checker,
/area/ruin/space/has_grav/hobbystation/recreational)
"jq" = (
/obj/effect/decal/cleanable/dirt/dust,
/turf/open/floor/iron/dark/textured_corner{
	dir = 8
	},
/area/ruin/space/has_grav/hobbystation/commons)
"jr" = (
/turf/closed/wall/r_wall,
/area/ruin/space/has_grav/hobbystation/central)
"jH" = (
/obj/structure/table,
/obj/item/pizzabox{
	pixel_x = 3;
	pixel_y = 9
	},
/turf/open/floor/iron/cafeteria,
/area/ruin/space/has_grav/hobbystation/central)
"jP" = (
/turf/open/floor/iron/dark/side{
	dir = 8
	},
/area/ruin/space/has_grav/hobbystation/recreational)
"jY" = (
/turf/open/floor/iron/smooth_half,
/area/ruin/space/has_grav/hobbystation/commons)
"kt" = (
/obj/structure/table,
/obj/item/plate{
	pixel_y = 2
	},
/turf/open/floor/iron/cafeteria,
/area/ruin/space/has_grav/hobbystation/central)
"kY" = (
/obj/effect/decal/cleanable/blood/tracks{
	dir = 1
	},
/obj/effect/decal/cleanable/blood/bubblegum{
	icon_state = "drip1"
	},
/turf/open/misc/asteroid,
/area/template_noop)
"lp" = (
/obj/effect/decal/cleanable/blood/bubblegum{
	icon_state = "armorblood"
	},
/obj/effect/decal/cleanable/blood/bubblegum{
	icon_state = "armorblood"
	},
/turf/closed/mineral/random,
/area/template_noop)
"lq" = (
/obj/structure/mirror/directional{
	pixel_y = 30;
	pixel_x = -1
	},
/obj/structure/sink/directional/south,
/obj/effect/decal/cleanable/dirt/dust,
/turf/open/floor/iron/dark/textured_corner,
/area/ruin/space/has_grav/hobbystation/commons)
"lI" = (
/obj/structure/closet/secure_closet/freezer/kitchen,
/obj/item/reagent_containers/condiment/milk,
/obj/item/reagent_containers/condiment/milk,
/obj/item/reagent_containers/condiment/flour,
/obj/item/reagent_containers/condiment/flour,
/obj/item/reagent_containers/condiment/sugar,
/obj/item/reagent_containers/condiment/sugar,
/obj/item/reagent_containers/condiment/rice,
/obj/effect/decal/cleanable/dirt/dust,
/turf/open/floor/iron/kitchen,
/area/ruin/space/has_grav/hobbystation/commons/kitchen)
"lX" = (
/obj/structure/sign/poster/official/get_your_legs,
/turf/closed/wall,
/area/ruin/space/has_grav/hobbystation/commons)
"mm" = (
/obj/machinery/gibber,
/obj/effect/decal/cleanable/dirt/dust,
/turf/open/floor/iron/kitchen,
/area/ruin/space/has_grav/hobbystation/commons/kitchen)
"mC" = (
/obj/effect/decal/cleanable/blood/bubblegum{
	icon_state = "gib3-old"
	},
/turf/open/misc/asteroid,
/area/template_noop)
"mI" = (
/obj/structure/sign/poster/official/cleanliness,
/turf/closed/wall,
/area/ruin/space/has_grav/hobbystation/commons)
"nI" = (
/obj/machinery/door/airlock/public,
/turf/open/floor/iron/dark/side{
	dir = 4
	},
/area/ruin/space/has_grav/hobbystation/central)
"nQ" = (
/obj/effect/decal/cleanable/blood,
/turf/open/misc/asteroid,
/area/template_noop)
"os" = (
/obj/structure/sign/poster/official/build,
/turf/closed/wall,
/area/ruin/space/has_grav/hobbystation/commons)
"oX" = (
/turf/open/floor/iron/dark/textured_corner{
	dir = 1
	},
/area/ruin/space/has_grav/hobbystation/commons)
"pn" = (
/obj/machinery/door/airlock/public/glass,
/turf/open/floor/iron/kitchen,
/area/ruin/space/has_grav/hobbystation/central)
"pE" = (
/obj/machinery/processor,
/obj/effect/decal/cleanable/dirt/dust,
/turf/open/floor/iron/kitchen,
/area/ruin/space/has_grav/hobbystation/commons/kitchen)
"pI" = (
/obj/effect/turf_decal/trimline/dark/filled/corner,
/obj/effect/turf_decal/trimline/dark/filled/corner{
	dir = 4
	},
/turf/open/floor/iron/large,
/area/ruin/space/has_grav/hobbystation/central)
"pR" = (
/obj/effect/decal/cleanable/blood/tracks{
	dir = 1
	},
/obj/effect/decal/cleanable/blood/tracks{
	dir = 1
	},
/obj/effect/decal/cleanable/blood/bubblegum{
	icon_state = "drip4"
	},
/turf/open/misc/asteroid,
/area/template_noop)
"qb" = (
/obj/effect/turf_decal/trimline/dark/filled/warning{
	dir = 8
	},
/obj/structure/sign/painting/library{
	pixel_x = -31
	},
/turf/open/floor/iron/large,
/area/ruin/space/has_grav/hobbystation/central)
"qq" = (
/obj/machinery/griddle,
/obj/effect/decal/cleanable/dirt/dust,
/turf/open/floor/iron/kitchen,
/area/ruin/space/has_grav/hobbystation/commons/kitchen)
"qv" = (
/obj/structure/table,
/obj/effect/decal/cleanable/dirt/dust,
/obj/structure/window/reinforced{
	dir = 1
	},
/turf/open/floor/iron/dark/side{
	dir = 4
	},
/area/ruin/space/has_grav/hobbystation/recreational)
"qS" = (
/obj/effect/decal/cleanable/dirt/dust,
/turf/open/floor/iron/dark/corner{
	dir = 1
	},
/area/ruin/space/has_grav/hobbystation/recreational)
"qW" = (
/obj/structure/sink{
	dir = 1;
	pixel_y = -13
	},
/obj/structure/mirror{
	pixel_y = -29
	},
/turf/open/floor/iron/dark/textured_corner{
	dir = 4
	},
/area/ruin/space/has_grav/hobbystation/commons)
"qZ" = (
/obj/effect/turf_decal/trimline/dark/filled/warning{
	dir = 8
	},
/turf/open/floor/iron/large,
/area/ruin/space/has_grav/hobbystation/central)
"rb" = (
/obj/effect/decal/cleanable/dirt/dust,
/turf/open/floor/iron/kitchen/small,
/area/ruin/space/has_grav/hobbystation/commons/kitchen)
"ri" = (
/obj/effect/decal/cleanable/dirt/dust,
/turf/open/floor/iron/dark/side{
	dir = 8
	},
/area/ruin/space/has_grav/hobbystation/recreational)
"rI" = (
/turf/closed/wall,
/area/ruin/space/has_grav/hobbystation/central)
"sx" = (
/obj/structure/lattice/catwalk,
/obj/structure/marker_beacon/indigo,
/turf/open/space/basic,
/area/template_noop)
"tc" = (
/turf/closed/wall,
/area/ruin/space/has_grav/hobbystation/recreational)
"tH" = (
/obj/structure/chair/plastic{
	dir = 4
	},
/turf/open/floor/iron/cafeteria,
/area/ruin/space/has_grav/hobbystation/central)
"uR" = (
/obj/effect/turf_decal/trimline/dark/filled/warning{
	dir = 4
	},
/obj/effect/decal/cleanable/dirt/dust,
/turf/open/floor/iron/large,
/area/ruin/space/has_grav/hobbystation/central)
"vz" = (
/turf/open/floor/iron/dark/textured_corner{
	dir = 8
	},
/area/ruin/space/has_grav/hobbystation/commons)
"vY" = (
/obj/effect/decal/cleanable/dirt/dust,
/obj/structure/window/reinforced{
	dir = 8
	},
/turf/open/floor/iron/checker,
/area/ruin/space/has_grav/hobbystation/recreational)
"wl" = (
/obj/effect/mob_spawn/corpse/human,
/obj/effect/decal/cleanable/blood/bubblegum{
	icon_state = "floor2"
	},
/turf/open/misc/asteroid,
/area/template_noop)
"xw" = (
/obj/structure/sign/nanotrasen,
/obj/structure/marker_beacon/indigo,
/turf/closed/wall,
/area/template_noop)
"xC" = (
/obj/structure/table,
/obj/item/storage/dice{
	pixel_y = 8;
	pixel_x = 11
	},
/turf/open/floor/iron/cafeteria,
/area/ruin/space/has_grav/hobbystation/central)
"yf" = (
/obj/machinery/chem_master/condimaster,
/turf/open/floor/iron/kitchen,
/area/ruin/space/has_grav/hobbystation/commons/kitchen)
"yl" = (
/obj/effect/turf_decal/trimline/dark/filled/warning,
/turf/open/floor/iron/large,
/area/ruin/space/has_grav/hobbystation/central)
"yv" = (
/obj/structure/table,
/obj/item/paper_bin{
	pixel_y = 6
	},
/turf/open/floor/iron/cafeteria,
/area/ruin/space/has_grav/hobbystation/central)
"yL" = (
/obj/effect/decal/cleanable/dirt/dust,
/turf/open/floor/iron/cafeteria,
/area/ruin/space/has_grav/hobbystation/central)
"yW" = (
/obj/machinery/oven,
/obj/effect/decal/cleanable/dirt/dust,
/turf/open/floor/iron/kitchen,
/area/ruin/space/has_grav/hobbystation/commons/kitchen)
"Ay" = (
/obj/effect/turf_decal/trimline/dark/filled/warning,
/obj/structure/sign/painting/library{
	pixel_y = -32
	},
/obj/effect/decal/cleanable/dirt/dust,
/turf/open/floor/iron/large,
/area/ruin/space/has_grav/hobbystation/central)
"Bg" = (
/obj/effect/decal/cleanable/dirt/dust,
/turf/open/floor/iron/dark/side{
	dir = 4
	},
/area/ruin/space/has_grav/hobbystation/recreational)
"BX" = (
/obj/effect/decal/cleanable/blood/tracks{
	dir = 10
	},
/turf/open/misc/asteroid,
/area/template_noop)
"Cd" = (
/obj/structure/closet/crate/wooden,
/obj/item/toy/plush/lizard_plushie/green{
	name = "Waits-The-Long";
	desc = "An adorable stuffed toy that resembles a green lizardperson. This one fills you with nostalgia and dust all over it."
	},
/obj/effect/decal/cleanable/dirt/dust,
/turf/open/floor/iron/dark/textured_large,
/area/ruin/space/has_grav/hobbystation/recreational)
"CU" = (
/obj/structure/window/reinforced{
	dir = 4
	},
/turf/open/floor/iron/checker,
/area/ruin/space/has_grav/hobbystation/recreational)
"CV" = (
/obj/structure/table,
/obj/item/toy/cards/deck{
	pixel_y = 7
	},
/turf/open/floor/iron/cafeteria,
/area/ruin/space/has_grav/hobbystation/central)
"Di" = (
/obj/structure/window/reinforced,
/turf/open/floor/iron/checker,
/area/ruin/space/has_grav/hobbystation/recreational)
"DK" = (
/obj/structure/table/reinforced,
/obj/item/paper/fluff/ruins/hobbystation/infofluff,
/turf/open/floor/iron/dark/textured_corner,
/area/ruin/space/has_grav/hobbystation/commons)
"DT" = (
/obj/structure/table,
/obj/item/reagent_containers/condiment/enzyme{
	layer = 5
	},
/obj/item/reagent_containers/cup/beaker,
/obj/machinery/reagentgrinder{
	pixel_y = 12;
	pixel_x = 3
	},
/obj/effect/decal/cleanable/dirt/dust,
/turf/open/floor/iron/kitchen,
/area/ruin/space/has_grav/hobbystation/commons/kitchen)
"Eg" = (
/obj/structure/chair/plastic{
	dir = 8
	},
/turf/open/floor/iron/cafeteria,
/area/ruin/space/has_grav/hobbystation/central)
"ER" = (
/obj/structure/table,
/obj/machinery/microwave{
	pixel_y = 6
	},
/turf/open/floor/iron/kitchen,
/area/ruin/space/has_grav/hobbystation/commons/kitchen)
"Fe" = (
/obj/structure/chair/plastic{
	dir = 1
	},
/obj/effect/decal/cleanable/dirt/dust,
/turf/open/floor/iron/cafeteria,
/area/ruin/space/has_grav/hobbystation/central)
"Fk" = (
/obj/effect/turf_decal/trimline/dark/filled/warning{
	dir = 4
	},
/turf/open/floor/iron/large,
/area/ruin/space/has_grav/hobbystation/central)
"FT" = (
/obj/structure/table/reinforced,
/obj/structure/desk_bell{
	pixel_y = 5
	},
/turf/open/floor/iron/cafeteria,
/area/ruin/space/has_grav/hobbystation/central)
"Gi" = (
/obj/structure/window/reinforced{
	dir = 1
	},
/turf/open/floor/iron/checker,
/area/ruin/space/has_grav/hobbystation/recreational)
"Gk" = (
/obj/structure/table,
/obj/effect/decal/cleanable/food/tomato_smudge,
/turf/open/floor/iron/cafeteria,
/area/ruin/space/has_grav/hobbystation/central)
"GA" = (
/turf/open/floor/iron/cafeteria,
/area/ruin/space/has_grav/hobbystation/central)
"HF" = (
/obj/effect/decal/cleanable/blood/tracks{
	dir = 8
	},
/turf/open/misc/asteroid,
/area/template_noop)
"HJ" = (
/obj/structure/chair/plastic,
/turf/open/floor/iron/cafeteria,
/area/ruin/space/has_grav/hobbystation/central)
"HL" = (
/obj/structure/chair/plastic{
	dir = 1
	},
/obj/effect/decal/cleanable/food/tomato_smudge,
/turf/open/floor/iron/cafeteria,
/area/ruin/space/has_grav/hobbystation/central)
"Ic" = (
/obj/structure/sign/poster/official/work_for_a_future,
/turf/closed/wall,
/area/ruin/space/has_grav/hobbystation/commons)
"Io" = (
/turf/open/floor/iron/dark/corner{
	dir = 4
	},
/area/ruin/space/has_grav/hobbystation/recreational)
"IS" = (
/obj/structure/chair/plastic,
/obj/effect/decal/cleanable/dirt/dust,
/turf/open/floor/iron/cafeteria,
/area/ruin/space/has_grav/hobbystation/central)
"JF" = (
/obj/machinery/oven,
/turf/open/floor/iron/kitchen,
/area/ruin/space/has_grav/hobbystation/commons/kitchen)
"JJ" = (
/obj/effect/decal/cleanable/dirt/dust,
/obj/effect/turf_decal/trimline/dark/filled/warning{
	dir = 4
	},
/turf/open/floor/iron/large,
/area/ruin/space/has_grav/hobbystation/central)
"KA" = (
/obj/effect/decal/cleanable/food/flour,
/turf/open/floor/iron/kitchen/small,
/area/ruin/space/has_grav/hobbystation/commons/kitchen)
"KJ" = (
/turf/closed/wall/r_wall,
/area/ruin/space/has_grav/hobbystation/commons/kitchen)
"KM" = (
/turf/open/floor/iron/kitchen,
/area/ruin/space/has_grav/hobbystation/commons/kitchen)
"Lg" = (
/turf/open/floor/iron/smooth,
/area/ruin/space/has_grav/hobbystation/commons)
"LH" = (
/obj/effect/decal/cleanable/dirt/dust,
/turf/open/floor/iron/dark/side{
	dir = 1
	},
/area/ruin/space/has_grav/hobbystation/recreational)
"LJ" = (
/obj/effect/decal/cleanable/dirt/dust,
/obj/effect/decal/cleanable/food/flour,
/turf/open/floor/iron/kitchen,
/area/ruin/space/has_grav/hobbystation/commons/kitchen)
"LY" = (
/turf/closed/wall,
/area/ruin/space/has_grav/hobbystation/commons)
"MP" = (
/turf/open/floor/iron/dark/side{
	dir = 4
	},
/area/ruin/space/has_grav/hobbystation/recreational)
"Nb" = (
/obj/structure/table/reinforced,
/obj/item/plate,
/turf/open/floor/iron/cafeteria,
/area/ruin/space/has_grav/hobbystation/central)
"Nk" = (
/obj/effect/decal/cleanable/blood/tracks{
	dir = 5
	},
/turf/open/misc/asteroid,
/area/template_noop)
"OG" = (
/obj/structure/table,
/turf/open/floor/iron/cafeteria,
/area/ruin/space/has_grav/hobbystation/central)
"Pa" = (
/obj/machinery/computer/holodeck,
/obj/effect/decal/cleanable/dirt/dust,
/obj/structure/window/reinforced{
	dir = 1
	},
/turf/open/floor/iron/dark/small,
/area/ruin/space/has_grav/hobbystation/recreational)
"PL" = (
/obj/effect/decal/cleanable/dirt/dust,
/obj/structure/window/reinforced,
/turf/open/floor/iron/checker,
/area/ruin/space/has_grav/hobbystation/recreational)
"PM" = (
/obj/structure/closet/secure_closet/freezer/kitchen,
/obj/effect/decal/cleanable/dirt/dust,
/turf/open/floor/iron/kitchen,
/area/ruin/space/has_grav/hobbystation/commons/kitchen)
"PN" = (
/obj/structure/closet/crate/wooden,
/obj/item/toy/beach_ball/holoball/dodgeball,
/obj/item/toy/beach_ball,
/turf/open/floor/iron/dark/textured_large,
/area/ruin/space/has_grav/hobbystation/recreational)
"QK" = (
/obj/machinery/vending/clothing,
/obj/effect/decal/cleanable/dirt/dust,
/turf/open/floor/iron/dark/textured_large,
/area/ruin/space/has_grav/hobbystation/recreational)
"Rz" = (
/turf/closed/wall/r_wall,
/area/ruin/space/has_grav/hobbystation/recreational)
"RB" = (
/obj/effect/turf_decal/trimline/dark/filled/warning,
/obj/effect/decal/cleanable/dirt/dust,
/turf/open/floor/iron/large,
/area/ruin/space/has_grav/hobbystation/central)
"Sq" = (
/obj/effect/decal/cleanable/dirt/dust,
/obj/effect/decal/cleanable/dirt/dust,
/turf/open/floor/iron/cafeteria,
/area/ruin/space/has_grav/hobbystation/central)
"SA" = (
/obj/effect/decal/cleanable/dirt/dust,
/obj/machinery/door/airlock/centcom,
/turf/open/floor/iron/dark/side{
	dir = 4
	},
/area/ruin/space/has_grav/hobbystation/commons)
"SG" = (
/obj/structure/sign/poster/official/help_others,
/turf/closed/wall,
/area/ruin/space/has_grav/hobbystation/commons)
"SR" = (
/obj/structure/sign/poster/official/here_for_your_safety,
/turf/closed/wall,
/area/ruin/space/has_grav/hobbystation/commons)
"Tb" = (
/obj/effect/decal/cleanable/dirt/dust,
/turf/open/floor/iron/smooth_half,
/area/ruin/space/has_grav/hobbystation/commons)
"TD" = (
/obj/structure/closet/crate/wooden,
/obj/effect/spawner/random/clothing/costume,
/obj/effect/spawner/random/decoration/glowstick,
/obj/effect/spawner/random/food_or_drink/donkpockets,
/obj/effect/decal/cleanable/dirt/dust,
/turf/open/floor/iron/dark/textured_large,
/area/ruin/space/has_grav/hobbystation/recreational)
"Up" = (
/obj/structure/chair/plastic,
/obj/effect/decal/cleanable/food/tomato_smudge,
/turf/open/floor/iron/cafeteria,
/area/ruin/space/has_grav/hobbystation/central)
"UK" = (
/turf/closed/mineral/random,
/area/template_noop)
"US" = (
/obj/effect/decal/cleanable/blood/tracks{
	dir = 1
	},
/turf/open/misc/asteroid,
/area/template_noop)
"UT" = (
/obj/machinery/vending/dinnerware,
/obj/effect/decal/cleanable/dirt/dust,
/turf/open/floor/iron/kitchen,
/area/ruin/space/has_grav/hobbystation/commons/kitchen)
"Vf" = (
/obj/structure/billboard/roadsign/twomillion,
/turf/open/misc/asteroid,
/area/template_noop)
"Vz" = (
/obj/effect/decal/cleanable/dirt/dust,
/turf/open/floor/iron/checker,
/area/ruin/space/has_grav/hobbystation/recreational)
"WP" = (
/obj/effect/decal/cleanable/dirt/dust,
/turf/open/floor/iron/kitchen,
/area/ruin/space/has_grav/hobbystation/commons/kitchen)
"WR" = (
/obj/effect/decal/cleanable/dirt/dust,
/obj/effect/decal/cleanable/food/tomato_smudge,
/turf/open/floor/iron/cafeteria,
/area/ruin/space/has_grav/hobbystation/central)
"WV" = (
/obj/structure/chair/plastic{
	dir = 1
	},
/turf/open/floor/iron/cafeteria,
/area/ruin/space/has_grav/hobbystation/central)
"Xq" = (
/obj/machinery/deepfryer,
/turf/open/floor/iron/kitchen,
/area/ruin/space/has_grav/hobbystation/commons/kitchen)
"Xz" = (
/turf/template_noop,
/area/template_noop)
"XF" = (
/obj/structure/table/reinforced,
/obj/item/paper/fluff/ruins/hobbystation/infofluff,
/obj/effect/decal/cleanable/dirt/dust,
/turf/open/floor/iron/dark/textured_corner{
	dir = 4
	},
/area/ruin/space/has_grav/hobbystation/commons)
"XN" = (
/obj/structure/sink{
	dir = 1;
	pixel_y = -13
	},
/obj/structure/mirror{
	pixel_y = -29
	},
/obj/effect/decal/cleanable/dirt/dust,
/turf/open/floor/iron/dark/textured_corner{
	dir = 4
	},
/area/ruin/space/has_grav/hobbystation/commons)
"XY" = (
/obj/machinery/door/airlock/centcom,
/turf/open/floor/plating,
/area/ruin/space/has_grav/hobbystation/commons)
"Yj" = (
/obj/effect/decal/cleanable/dirt/dust,
/turf/open/floor/iron/dark/textured_corner{
	dir = 1
	},
/area/ruin/space/has_grav/hobbystation/commons)
"Yw" = (
/obj/effect/turf_decal/trimline/dark/filled/warning{
	dir = 8
	},
/obj/effect/decal/cleanable/dirt/dust,
/turf/open/floor/iron/large,
/area/ruin/space/has_grav/hobbystation/central)
"YH" = (
/turf/open/floor/iron/kitchen/small,
/area/ruin/space/has_grav/hobbystation/commons/kitchen)
"YJ" = (
/turf/open/misc/asteroid,
/area/template_noop)
"ZH" = (
/turf/open/floor/engine{
	name = "Holodeck Projector Floor"
	},
/area/ruin/space/has_grav/hobbystation/holodeck)

(1,1,1) = {"
Xz
Xz
Xz
Xz
Xz
Xz
Xz
Xz
Xz
Xz
Xz
Xz
Xz
Xz
Xz
Xz
Xz
Xz
Xz
Xz
Xz
Xz
Xz
Xz
Xz
Xz
Xz
Xz
Xz
Xz
Xz
Xz
Xz
Xz
Xz
Xz
Xz
Xz
Xz
Xz
Xz
Xz
Xz
Xz
Xz
Xz
Xz
Xz
Xz
Xz
"}
(2,1,1) = {"
Xz
Xz
Xz
Xz
Xz
Xz
Xz
Xz
Xz
Xz
Xz
Xz
Xz
Xz
Xz
Xz
Xz
Xz
Xz
Xz
Xz
Xz
Xz
Xz
Xz
Xz
Xz
Xz
Xz
Xz
Xz
Xz
Xz
Xz
Xz
Xz
Xz
Xz
Xz
Xz
Xz
Xz
Xz
Xz
Xz
Xz
Xz
Xz
Xz
Xz
"}
(3,1,1) = {"
Xz
Xz
Xz
Xz
Xz
Xz
Xz
Xz
Xz
Xz
Xz
Xz
Xz
Xz
Xz
Xz
Xz
Xz
Xz
Xz
Xz
Xz
Xz
Xz
Xz
Xz
Xz
Xz
Xz
Xz
Xz
Xz
Xz
Xz
Xz
Xz
Xz
Xz
Xz
Xz
Xz
Xz
Xz
Xz
Xz
Xz
Xz
Xz
Xz
Xz
"}
(4,1,1) = {"
Xz
Xz
Xz
Xz
Xz
Xz
Xz
Xz
Xz
Xz
Xz
Xz
Xz
Xz
Xz
Xz
Xz
Xz
Xz
Xz
Xz
Xz
Xz
Xz
sx
Xz
Xz
Xz
Xz
Xz
Xz
Xz
Xz
Xz
Xz
Xz
Xz
Xz
Xz
Xz
Xz
Xz
Xz
Xz
Xz
Xz
Xz
Xz
Xz
Xz
"}
(5,1,1) = {"
Xz
Xz
Xz
Xz
Xz
Xz
Xz
Xz
Xz
Xz
Xz
Xz
Xz
Xz
Xz
Xz
Xz
Xz
Xz
Xz
Xz
Xz
UK
UK
xw
UK
UK
Xz
Xz
Xz
Xz
Xz
Xz
Xz
Xz
Xz
Xz
Xz
Xz
Xz
Xz
Xz
Xz
Xz
Xz
Xz
Xz
Xz
Xz
Xz
"}
(6,1,1) = {"
Xz
Xz
Xz
Xz
Xz
Xz
Xz
Xz
Xz
Xz
Xz
Xz
Xz
Xz
Xz
UK
UK
UK
UK
UK
UK
UK
UK
UK
UK
UK
UK
UK
Nk
kY
US
pR
eg
dM
BX
YJ
UK
UK
Xz
Xz
Xz
Xz
Xz
Xz
Xz
Xz
Xz
Xz
Xz
Xz
"}
(7,1,1) = {"
Xz
Xz
Xz
Xz
Xz
Xz
Xz
Xz
Xz
Xz
Xz
Xz
UK
UK
UK
UK
UK
UK
UK
UK
UK
UK
UK
UK
UK
UK
UK
UK
UK
UK
nQ
YJ
YJ
YJ
HF
UK
UK
UK
UK
Xz
Xz
Xz
Xz
Xz
Xz
Xz
Xz
Xz
Xz
Xz
"}
(8,1,1) = {"
Xz
Xz
Xz
Xz
Xz
Xz
Xz
Xz
Xz
Xz
Xz
Xz
UK
UK
UK
UK
UK
UK
UK
UK
UK
UK
UK
UK
UK
UK
UK
UK
lp
UK
UK
UK
UK
UK
HF
UK
UK
UK
UK
UK
UK
Xz
Xz
Xz
Xz
Xz
Xz
Xz
Xz
Xz
"}
(9,1,1) = {"
Xz
Xz
Xz
Xz
Xz
Xz
Xz
Xz
Xz
Xz
UK
UK
UK
UK
UK
UK
UK
UK
UK
UK
UK
UK
UK
UK
UK
UK
UK
UK
UK
UK
UK
UK
UK
UK
HF
UK
UK
UK
UK
UK
UK
Xz
Xz
Xz
Xz
Xz
Xz
Xz
Xz
Xz
"}
(10,1,1) = {"
Xz
Xz
Xz
Xz
Xz
Xz
Xz
UK
UK
UK
UK
UK
UK
UK
UK
UK
UK
UK
UK
UK
UK
UK
UK
UK
UK
UK
UK
UK
UK
UK
UK
UK
UK
UK
wl
YJ
YJ
mC
YJ
YJ
YJ
YJ
YJ
Xz
Xz
Xz
Xz
Xz
Xz
Xz
"}
(11,1,1) = {"
Xz
Xz
Xz
Xz
Xz
UK
UK
UK
UK
UK
UK
UK
UK
UK
UK
UK
UK
UK
UK
UK
UK
UK
UK
UK
UK
UK
UK
UK
UK
UK
UK
UK
UK
UK
UK
UK
UK
UK
UK
UK
YJ
YJ
YJ
Xz
Xz
Xz
Xz
Xz
Xz
Xz
"}
(12,1,1) = {"
Xz
Xz
Xz
Xz
Xz
UK
UK
UK
UK
UK
UK
UK
UK
UK
UK
UK
UK
UK
UK
UK
UK
UK
UK
KJ
KJ
KJ
KJ
KJ
jr
jr
jr
jr
jr
jr
jr
jr
jr
jr
jr
UK
YJ
YJ
Xz
Xz
Xz
Xz
Xz
Xz
Xz
Xz
"}
(13,1,1) = {"
Xz
Xz
Xz
Xz
UK
UK
UK
UK
UK
UK
UK
UK
UK
UK
UK
UK
UK
UK
UK
UK
UK
UK
UK
KJ
UT
JF
yW
Xq
rI
Yw
dg
qZ
qb
Yw
qb
Yw
qb
er
jr
UK
YJ
YJ
Xz
Xz
Xz
Xz
Xz
Xz
Xz
Xz
"}
(14,1,1) = {"
Xz
Xz
Xz
Xz
UK
UK
UK
UK
UK
UK
UK
UK
UK
UK
UK
UK
UK
UK
UK
UK
UK
UK
UK
KJ
WP
rb
KA
WP
rI
GA
GA
yL
GA
yL
GA
yL
yL
Ay
jr
UK
YJ
YJ
YJ
YJ
Xz
Xz
Xz
Xz
Xz
Xz
"}
(15,1,1) = {"
Xz
Xz
Xz
Xz
UK
UK
UK
UK
UK
UK
UK
UK
UK
UK
UK
UK
UK
UK
UK
UK
UK
UK
UK
KJ
fu
YH
rb
WP
Nb
Sq
hb
tH
WR
GA
yL
tH
yL
yl
jr
UK
YJ
YJ
YJ
YJ
Xz
Xz
Xz
Xz
Xz
Xz
"}
(16,1,1) = {"
Xz
Xz
Xz
Xz
UK
UK
UK
UK
UK
UK
UK
UK
UK
UK
UK
UK
UK
UK
UK
UK
UK
UK
UK
KJ
yf
YH
YH
WP
Nb
GA
IS
OG
WV
GA
HJ
yv
HL
Ay
jr
UK
YJ
UK
UK
UK
Xz
Xz
Xz
Xz
Xz
Xz
"}
(17,1,1) = {"
Xz
Xz
Xz
Xz
UK
UK
UK
UK
UK
UK
UK
UK
UK
UK
UK
UK
UK
UK
UK
UK
UK
UK
UK
KJ
DT
rb
rb
WP
gJ
GA
HJ
kt
WV
yL
HJ
xC
WV
RB
jr
UK
YJ
UK
UK
UK
Xz
Xz
Xz
Xz
Xz
Xz
"}
(18,1,1) = {"
Xz
Xz
Xz
Xz
Xz
UK
UK
UK
UK
UK
UK
UK
UK
UK
UK
UK
UK
UK
UK
UK
UK
UK
UK
KJ
qq
KA
rb
WP
Nb
yL
IS
Gk
WV
GA
HJ
OG
WV
aE
jr
UK
YJ
UK
UK
UK
UK
UK
Xz
Xz
Xz
Xz
"}
(19,1,1) = {"
Xz
Xz
Xz
Xz
Xz
UK
UK
UK
UK
UK
UK
UK
UK
UK
UK
UK
UK
UK
UK
UK
UK
UK
UK
KJ
qq
YH
rb
KM
FT
GA
HJ
jH
WV
yL
HJ
OG
WV
RB
jr
UK
YJ
YJ
UK
UK
UK
UK
Xz
Xz
Xz
Xz
"}
(20,1,1) = {"
Xz
Xz
Xz
Xz
Xz
Xz
UK
UK
UK
UK
UK
UK
UK
UK
UK
UK
UK
UK
UK
UK
UK
UK
UK
KJ
ER
YH
YH
WP
Nb
yL
HJ
OG
WV
yL
HJ
CV
WV
Ay
jr
UK
UK
YJ
UK
UK
UK
UK
Xz
Xz
Xz
Xz
"}
(21,1,1) = {"
Xz
Xz
Xz
Xz
Xz
Xz
Xz
UK
UK
UK
UK
UK
UK
UK
UK
UK
UK
UK
UK
UK
UK
UK
UK
KJ
pE
rb
YH
KM
Nb
GA
Up
OG
WV
GA
Up
OG
Fe
RB
jr
UK
UK
YJ
YJ
UK
UK
UK
Xz
Xz
Xz
Xz
"}
(22,1,1) = {"
Xz
Xz
Xz
Xz
Xz
Xz
Xz
UK
UK
UK
UK
UK
UK
UK
UK
UK
UK
UK
UK
UK
UK
UK
UK
KJ
lI
rb
rb
LJ
Nb
GA
yL
Eg
GA
yL
GA
Eg
GA
Ay
jr
UK
UK
UK
YJ
YJ
UK
UK
UK
UK
Xz
Xz
"}
(23,1,1) = {"
Xz
Xz
Xz
Xz
Xz
Xz
Xz
UK
UK
UK
UK
UK
UK
UK
UK
UK
UK
UK
UK
UK
UK
UK
UK
KJ
PM
rb
rb
KM
rI
GA
yL
yL
hb
yL
GA
yL
yL
yl
jr
UK
UK
UK
UK
YJ
UK
UK
UK
UK
Xz
Xz
"}
(24,1,1) = {"
Xz
Xz
Xz
Xz
Xz
Xz
Xz
UK
UK
UK
UK
UK
UK
UK
UK
UK
UK
UK
UK
UK
UK
UK
UK
KJ
mm
dX
ba
WP
pn
Fk
Fk
pI
JJ
Fk
Fk
uR
Fk
gf
jr
UK
UK
UK
UK
YJ
YJ
UK
UK
UK
UK
Xz
"}
(25,1,1) = {"
Xz
Xz
Xz
Xz
Xz
Xz
Xz
Xz
UK
UK
UK
UK
UK
UK
UK
UK
UK
UK
Rz
Rz
Rz
Rz
Rz
iQ
iQ
iQ
iQ
iQ
rI
rI
rI
nI
rI
LY
LY
LY
LY
SA
LY
LY
LY
gW
UK
UK
YJ
UK
UK
UK
UK
Xz
"}
(26,1,1) = {"
Xz
Xz
Xz
Xz
Xz
Xz
Xz
Xz
UK
UK
UK
UK
UK
UK
UK
UK
UK
UK
Rz
fU
Vz
fU
Vz
fU
Vz
fU
fU
fU
fU
fU
Vz
Vz
Vz
LY
ja
qW
LY
Lg
LY
lq
XF
gW
UK
UK
YJ
UK
UK
UK
Xz
Xz
"}
(27,1,1) = {"
Xz
Xz
Xz
Xz
Xz
Xz
Xz
Xz
UK
UK
UK
UK
UK
UK
UK
UK
UK
UK
Rz
fU
Vz
CU
CU
CU
Bg
MP
MP
Bg
hQ
CU
CU
fU
dY
LY
vz
Yj
XY
Tb
XY
vz
Yj
gW
UK
UK
YJ
UK
UK
Xz
Xz
Xz
"}
(28,1,1) = {"
Xz
Xz
Xz
Xz
Xz
Xz
Xz
sx
xw
UK
UK
UK
UK
UK
UK
UK
UK
UK
Rz
fU
Di
ZH
ZH
ZH
ZH
ZH
ZH
ZH
ZH
ZH
ZH
Gi
dY
LY
LY
LY
Ic
Tb
SG
LY
LY
gW
UK
UK
YJ
UK
Xz
Xz
Xz
Xz
"}
(29,1,1) = {"
Xz
Xz
Xz
Xz
Xz
Xz
Xz
Xz
UK
UK
UK
UK
UK
UK
UK
UK
UK
UK
Rz
Vz
PL
ZH
ZH
ZH
ZH
ZH
ZH
ZH
ZH
ZH
ZH
jb
fU
LY
ja
XN
LY
jY
LY
lq
XF
gW
UK
UK
YJ
xw
sx
Xz
Xz
Xz
"}
(30,1,1) = {"
Xz
Xz
Xz
Xz
Xz
Xz
Xz
Xz
UK
UK
UK
UK
UK
UK
UK
UK
UK
UK
Rz
Vz
Di
ZH
ZH
ZH
ZH
ZH
ZH
ZH
ZH
ZH
ZH
Gi
Vz
LY
vz
Yj
XY
Tb
XY
vz
Yj
gW
UK
UK
YJ
YJ
Xz
Xz
Xz
Xz
"}
(31,1,1) = {"
Xz
Xz
Xz
Xz
Xz
Xz
Xz
Xz
UK
UK
UK
UK
UK
UK
UK
UK
UK
UK
Rz
Vz
Di
ZH
ZH
ZH
ZH
ZH
ZH
ZH
ZH
ZH
ZH
qv
Io
LY
LY
LY
SR
Tb
lX
LY
LY
gW
UK
UK
YJ
YJ
Xz
Xz
Xz
Xz
"}
(32,1,1) = {"
Xz
Xz
Xz
Xz
Xz
Xz
Xz
UK
UK
UK
UK
UK
UK
UK
UK
UK
UK
UK
Rz
Vz
Di
ZH
ZH
ZH
ZH
ZH
ZH
ZH
ZH
ZH
ZH
Pa
LH
LY
DK
XN
LY
Tb
LY
lq
gG
gW
UK
UK
YJ
Vf
Xz
Xz
Xz
Xz
"}
(33,1,1) = {"
Xz
Xz
Xz
Xz
Xz
Xz
Xz
UK
UK
UK
UK
UK
UK
UK
UK
UK
UK
UK
Rz
Vz
Di
ZH
ZH
ZH
ZH
ZH
ZH
ZH
ZH
ZH
ZH
fK
qS
LY
vz
Yj
XY
jY
XY
vz
oX
gW
UK
UK
YJ
YJ
Xz
Xz
Xz
Xz
"}
(34,1,1) = {"
Xz
Xz
Xz
Xz
Xz
Xz
Xz
Xz
UK
UK
UK
UK
UK
UK
UK
UK
UK
UK
Rz
Vz
Di
ZH
ZH
ZH
ZH
ZH
ZH
ZH
ZH
ZH
ZH
Gi
fU
LY
LY
LY
os
Tb
mI
LY
LY
gW
UK
UK
YJ
YJ
Xz
Xz
Xz
Xz
"}
(35,1,1) = {"
Xz
Xz
Xz
Xz
Xz
Xz
Xz
Xz
UK
UK
UK
UK
UK
UK
UK
UK
UK
UK
Rz
Vz
Di
ZH
ZH
ZH
ZH
ZH
ZH
ZH
ZH
ZH
ZH
Gi
fU
LY
ja
XN
LY
Tb
LY
lq
gG
gW
UK
UK
YJ
YJ
Xz
Xz
Xz
Xz
"}
(36,1,1) = {"
Xz
Xz
Xz
Xz
Xz
Xz
Xz
Xz
Xz
UK
UK
UK
UK
UK
UK
UK
UK
UK
Rz
fU
Di
ZH
ZH
ZH
ZH
ZH
ZH
ZH
ZH
ZH
ZH
Gi
fU
LY
jq
oX
XY
Lg
XY
jq
Yj
gW
UK
UK
YJ
YJ
Xz
Xz
Xz
Xz
"}
(37,1,1) = {"
Xz
Xz
Xz
Xz
Xz
Xz
Xz
Xz
Xz
UK
UK
UK
UK
UK
UK
UK
UK
UK
fJ
fU
dY
gc
gc
gc
ri
ri
jP
jP
vY
gc
gc
dY
Vz
LY
gW
gW
gW
gW
gW
gW
gW
gW
UK
UK
UK
YJ
Xz
Xz
Xz
Xz
"}
(38,1,1) = {"
Xz
Xz
Xz
Xz
Xz
Xz
Xz
Xz
Xz
UK
UK
UK
UK
UK
UK
UK
UK
UK
Rz
Vz
dY
Vz
Vz
fU
Vz
fU
fU
fU
fU
fU
Vz
Vz
fU
Rz
UK
UK
UK
UK
UK
UK
UK
UK
UK
UK
Xz
Xz
Xz
Xz
Xz
Xz
"}
(39,1,1) = {"
Xz
Xz
Xz
Xz
Xz
Xz
Xz
Xz
Xz
Xz
Xz
UK
UK
UK
UK
UK
UK
UK
Rz
Rz
Rz
Rz
Rz
Rz
MP
MP
Bg
MP
Rz
Rz
Rz
Rz
Rz
Rz
UK
UK
UK
UK
UK
UK
UK
UK
UK
Xz
Xz
Xz
Xz
Xz
Xz
Xz
"}
(40,1,1) = {"
Xz
Xz
Xz
Xz
Xz
Xz
Xz
Xz
Xz
Xz
Xz
Xz
UK
UK
UK
UK
UK
UK
UK
UK
UK
UK
UK
tc
TD
PN
Cd
QK
tc
UK
UK
UK
UK
UK
UK
UK
UK
UK
UK
UK
UK
UK
Xz
Xz
Xz
Xz
Xz
Xz
Xz
Xz
"}
(41,1,1) = {"
Xz
Xz
Xz
Xz
Xz
Xz
Xz
Xz
Xz
Xz
Xz
Xz
Xz
Xz
Xz
UK
UK
UK
UK
UK
UK
UK
UK
tc
tc
tc
tc
tc
tc
UK
UK
UK
UK
UK
UK
UK
UK
UK
UK
UK
UK
UK
Xz
Xz
Xz
Xz
Xz
Xz
Xz
Xz
"}
(42,1,1) = {"
Xz
Xz
Xz
Xz
Xz
Xz
Xz
Xz
Xz
Xz
Xz
Xz
Xz
Xz
Xz
Xz
UK
UK
UK
UK
UK
UK
UK
UK
UK
UK
UK
UK
UK
UK
UK
UK
UK
UK
UK
UK
UK
UK
UK
UK
UK
Xz
Xz
Xz
Xz
Xz
Xz
Xz
Xz
Xz
"}
(43,1,1) = {"
Xz
Xz
Xz
Xz
Xz
Xz
Xz
Xz
Xz
Xz
Xz
Xz
Xz
Xz
Xz
Xz
Xz
UK
UK
UK
UK
UK
UK
UK
UK
UK
xw
UK
UK
UK
UK
UK
UK
UK
UK
UK
UK
UK
UK
UK
Xz
Xz
Xz
Xz
Xz
Xz
Xz
Xz
Xz
Xz
"}
(44,1,1) = {"
Xz
Xz
Xz
Xz
Xz
Xz
Xz
Xz
Xz
Xz
Xz
Xz
Xz
Xz
Xz
Xz
Xz
Xz
Xz
UK
UK
UK
UK
UK
Xz
Xz
sx
Xz
Xz
Xz
Xz
UK
UK
UK
UK
UK
UK
Xz
Xz
Xz
Xz
Xz
Xz
Xz
Xz
Xz
Xz
Xz
Xz
Xz
"}
(45,1,1) = {"
Xz
Xz
Xz
Xz
Xz
Xz
Xz
Xz
Xz
Xz
Xz
Xz
Xz
Xz
Xz
Xz
Xz
Xz
Xz
Xz
Xz
Xz
Xz
Xz
Xz
Xz
Xz
Xz
Xz
Xz
Xz
Xz
Xz
Xz
Xz
Xz
Xz
Xz
Xz
Xz
Xz
Xz
Xz
Xz
Xz
Xz
Xz
Xz
Xz
Xz
"}
(46,1,1) = {"
Xz
Xz
Xz
Xz
Xz
Xz
Xz
Xz
Xz
Xz
Xz
Xz
Xz
Xz
Xz
Xz
Xz
Xz
Xz
Xz
Xz
Xz
Xz
Xz
Xz
Xz
Xz
Xz
Xz
Xz
Xz
Xz
Xz
Xz
Xz
Xz
Xz
Xz
Xz
Xz
Xz
Xz
Xz
Xz
Xz
Xz
Xz
Xz
Xz
Xz
"}
(47,1,1) = {"
Xz
Xz
Xz
Xz
Xz
Xz
Xz
Xz
Xz
Xz
Xz
Xz
Xz
Xz
Xz
Xz
Xz
Xz
Xz
Xz
Xz
Xz
Xz
Xz
Xz
Xz
Xz
Xz
Xz
Xz
Xz
Xz
Xz
Xz
Xz
Xz
Xz
Xz
Xz
Xz
Xz
Xz
Xz
Xz
Xz
Xz
Xz
Xz
Xz
Xz
"}
(48,1,1) = {"
Xz
Xz
Xz
Xz
Xz
Xz
Xz
Xz
Xz
Xz
Xz
Xz
Xz
Xz
Xz
Xz
Xz
Xz
Xz
Xz
Xz
Xz
Xz
Xz
Xz
Xz
Xz
Xz
Xz
Xz
Xz
Xz
Xz
Xz
Xz
Xz
Xz
Xz
Xz
Xz
Xz
Xz
Xz
Xz
Xz
Xz
Xz
Xz
Xz
Xz
"}
(49,1,1) = {"
Xz
Xz
Xz
Xz
Xz
Xz
Xz
Xz
Xz
Xz
Xz
Xz
Xz
Xz
Xz
Xz
Xz
Xz
Xz
Xz
Xz
Xz
Xz
Xz
Xz
Xz
Xz
Xz
Xz
Xz
Xz
Xz
Xz
Xz
Xz
Xz
Xz
Xz
Xz
Xz
Xz
Xz
Xz
Xz
Xz
Xz
Xz
Xz
Xz
Xz
"}
(50,1,1) = {"
Xz
Xz
Xz
Xz
Xz
Xz
Xz
Xz
Xz
Xz
Xz
Xz
Xz
Xz
Xz
Xz
Xz
Xz
Xz
Xz
Xz
Xz
Xz
Xz
Xz
Xz
Xz
Xz
Xz
Xz
Xz
Xz
Xz
Xz
Xz
Xz
Xz
Xz
Xz
Xz
Xz
Xz
Xz
Xz
Xz
Xz
Xz
Xz
Xz
Xz
"}
