//MAP CONVERTED BY dmm2tgm.py THIS HEADER COMMENT PREVENTS RECONVERSION, DO NOT REMOVE
"a" = (
/turf/template_noop,
/area/template_noop)
"b" = (
/obj/effect/decal/cleanable/blood/tracks{
	dir = 1
	},
/obj/effect/decal/cleanable/blood/tracks{
	dir = 1
	},
/obj/effect/decal/cleanable/blood/bubblegum{
	icon_state = "drip4"
	},
/turf/open/misc/asteroid,
/area/template_noop)
"e" = (
/obj/effect/decal/cleanable/blood/tracks{
	dir = 1
	},
/obj/effect/decal/cleanable/blood/bubblegum{
	icon_state = "drip1"
	},
/turf/open/misc/asteroid,
/area/template_noop)
"f" = (
/turf/open/misc/asteroid,
/area/template_noop)
"h" = (
/obj/effect/decal/cleanable/blood/tracks{
	dir = 1
	},
/obj/effect/decal/cleanable/blood/bubblegum{
	icon_state = "drip3"
	},
/turf/open/misc/asteroid,
/area/template_noop)
"k" = (
/obj/structure/sign/poster/official/help_others,
/turf/closed/wall,
/area/template_noop)
"l" = (
/obj/structure/sign/poster/official/cleanliness,
/turf/closed/wall,
/area/template_noop)
"m" = (
/obj/structure/table/reinforced,
/turf/open/floor/iron/dark/textured_corner,
/area/template_noop)
"n" = (
/obj/effect/decal/cleanable/blood/tracks{
	dir = 10
	},
/turf/open/misc/asteroid,
/area/template_noop)
"o" = (
/obj/structure/table/reinforced,
/turf/open/floor/iron/dark/textured_corner{
	dir = 4
	},
/area/template_noop)
"p" = (
/obj/effect/mob_spawn/corpse/human,
/obj/effect/decal/cleanable/blood/bubblegum{
	icon_state = "floor2"
	},
/turf/open/misc/asteroid,
/area/template_noop)
"r" = (
/obj/structure/billboard/nanotrasen/defaced,
/turf/open/misc/asteroid,
/area/template_noop)
"s" = (
/obj/effect/decal/cleanable/blood/bubblegum{
	icon_state = "gib3-old"
	},
/turf/open/misc/asteroid,
/area/template_noop)
"t" = (
/turf/open/floor/engine{
	name = "Holodeck Projector Floor"
	},
/area/template_noop)
"u" = (
/obj/effect/decal/cleanable/blood/tracks{
	dir = 5
	},
/turf/open/misc/asteroid,
/area/template_noop)
"x" = (
/obj/effect/decal/cleanable/blood/tracks{
	dir = 1
	},
/obj/effect/decal/cleanable/blood/bubblegum{
	icon_state = "armorblood"
	},
/turf/open/misc/asteroid,
/area/template_noop)
"y" = (
/turf/open/floor/iron/dark/textured_corner{
	dir = 8
	},
/area/template_noop)
"z" = (
/turf/open/floor/iron/smooth_half,
/area/template_noop)
"D" = (
/turf/closed/wall/r_wall,
/area/template_noop)
"E" = (
/turf/closed/mineral/random,
/area/template_noop)
"F" = (
/obj/effect/decal/cleanable/blood/bubblegum{
	icon_state = "armorblood"
	},
/obj/effect/decal/cleanable/blood/bubblegum{
	icon_state = "armorblood"
	},
/turf/closed/mineral/random,
/area/template_noop)
"G" = (
/obj/structure/sign/poster/official/get_your_legs,
/turf/closed/wall,
/area/template_noop)
"I" = (
/obj/structure/sign/nanotrasen,
/obj/structure/marker_beacon/indigo,
/turf/closed/wall,
/area/template_noop)
"J" = (
/obj/effect/decal/cleanable/blood/tracks{
	dir = 1
	},
/turf/open/misc/asteroid,
/area/template_noop)
"K" = (
/turf/open/floor/iron/dark/textured_corner{
	dir = 1
	},
/area/template_noop)
"L" = (
/obj/machinery/door/airlock/centcom,
/turf/open/floor/plating,
/area/template_noop)
"M" = (
/obj/structure/sign/poster/official/build,
/turf/closed/wall,
/area/template_noop)
"P" = (
/obj/structure/mirror/directional{
	pixel_y = 30;
	pixel_x = -1
	},
/obj/structure/sink/directional/south,
/turf/open/floor/iron/dark/textured_corner,
/area/template_noop)
"Q" = (
/obj/structure/sign/poster/official/here_for_your_safety,
/turf/closed/wall,
/area/template_noop)
"S" = (
/turf/open/floor/iron/smooth,
/area/template_noop)
"T" = (
/obj/effect/decal/cleanable/blood,
/turf/open/misc/asteroid,
/area/template_noop)
"U" = (
/obj/structure/lattice/catwalk,
/obj/structure/marker_beacon/indigo,
/turf/open/space/basic,
/area/template_noop)
"V" = (
/obj/structure/sign/poster/official/work_for_a_future,
/turf/closed/wall,
/area/template_noop)
"W" = (
/obj/structure/sink{
	dir = 1;
	pixel_y = -13
	},
/obj/structure/mirror{
	pixel_y = -29
	},
/turf/open/floor/iron/dark/textured_corner{
	dir = 4
	},
/area/template_noop)
"X" = (
/turf/closed/wall,
/area/template_noop)
"Y" = (
/obj/effect/decal/cleanable/blood/tracks{
	dir = 8
	},
/turf/open/misc/asteroid,
/area/template_noop)

(1,1,1) = {"
a
a
a
a
a
a
a
a
a
a
a
a
a
a
a
a
a
a
a
a
a
a
a
a
a
a
a
a
a
a
a
a
a
a
a
a
a
a
a
a
a
a
a
a
a
a
a
a
a
a
"}
(2,1,1) = {"
a
a
a
a
a
a
a
a
a
a
a
a
a
a
a
a
a
a
a
a
a
a
a
a
a
a
a
a
a
a
a
a
a
a
a
a
a
a
a
a
a
a
a
a
a
a
a
a
a
a
"}
(3,1,1) = {"
a
a
a
a
a
a
a
a
a
a
a
a
a
a
a
a
a
a
a
a
a
a
a
a
a
a
a
a
a
a
a
a
a
a
a
a
a
a
a
a
a
a
a
a
a
a
a
a
a
a
"}
(4,1,1) = {"
a
a
a
a
a
a
a
a
a
a
a
a
a
a
a
a
a
a
a
a
a
a
a
a
U
a
a
a
a
a
a
a
a
a
a
a
a
a
a
a
a
a
a
a
a
a
a
a
a
a
"}
(5,1,1) = {"
a
a
a
a
a
a
a
a
a
a
a
a
a
a
a
a
a
a
a
a
a
a
E
E
I
E
E
a
a
a
a
a
a
a
a
a
a
a
a
a
a
a
a
a
a
a
a
a
a
a
"}
(6,1,1) = {"
a
a
a
a
a
a
a
a
a
a
a
a
a
a
a
E
E
E
E
E
E
E
E
E
E
E
E
E
u
e
J
b
h
x
n
f
E
E
a
a
a
a
a
a
a
a
a
a
a
a
"}
(7,1,1) = {"
a
a
a
a
a
a
a
a
a
a
a
a
E
E
E
E
E
E
E
E
E
E
E
E
E
E
E
E
E
E
T
f
f
f
Y
E
E
E
E
a
a
a
a
a
a
a
a
a
a
a
"}
(8,1,1) = {"
a
a
a
a
a
a
a
a
a
a
a
a
E
E
E
E
E
E
E
E
E
E
E
E
E
E
E
E
F
E
E
E
E
E
Y
E
E
E
E
E
E
a
a
a
a
a
a
a
a
a
"}
(9,1,1) = {"
a
a
a
a
a
a
a
a
a
a
E
E
E
E
E
E
E
E
E
E
E
E
E
E
E
E
E
E
E
E
E
E
E
E
Y
E
E
E
E
E
E
a
a
a
a
a
a
a
a
a
"}
(10,1,1) = {"
a
a
a
a
a
a
a
E
E
E
E
E
E
E
E
E
E
E
E
E
E
E
E
E
E
E
E
E
E
E
E
E
E
E
p
f
f
s
f
f
f
f
f
a
a
a
a
a
a
a
"}
(11,1,1) = {"
a
a
a
a
a
E
E
E
E
E
E
E
E
E
E
E
E
E
E
E
E
E
E
E
E
E
E
E
E
E
E
E
E
E
E
E
E
E
E
E
f
f
f
a
a
a
a
a
a
a
"}
(12,1,1) = {"
a
a
a
a
a
E
E
E
E
E
E
E
E
E
E
E
E
E
E
E
E
E
E
E
E
E
E
E
E
E
E
E
E
E
E
E
E
E
E
E
f
f
a
a
a
a
a
a
a
a
"}
(13,1,1) = {"
a
a
a
a
E
E
E
E
E
E
E
E
E
E
E
E
E
E
E
E
E
E
E
E
E
E
E
E
E
E
E
E
E
E
E
E
E
E
E
E
f
f
a
a
a
a
a
a
a
a
"}
(14,1,1) = {"
a
a
a
a
E
E
E
E
E
E
E
E
E
E
E
E
E
E
E
E
E
E
E
E
E
E
E
E
E
E
E
E
E
E
E
E
E
E
E
E
f
f
f
f
a
a
a
a
a
a
"}
(15,1,1) = {"
a
a
a
a
E
E
E
E
E
E
E
E
E
E
E
E
E
E
E
E
E
E
E
E
E
E
E
E
E
E
E
E
E
E
E
E
E
E
E
E
f
f
f
f
a
a
a
a
a
a
"}
(16,1,1) = {"
a
a
a
a
E
E
E
E
E
E
E
E
E
E
E
E
E
E
E
E
E
E
E
E
E
E
E
E
E
E
E
E
E
E
E
E
E
E
E
E
f
E
E
E
a
a
a
a
a
a
"}
(17,1,1) = {"
a
a
a
a
E
E
E
E
E
E
E
E
E
E
E
E
E
E
E
E
E
E
E
E
E
E
E
E
E
E
E
E
E
E
E
E
E
E
E
E
f
E
E
E
a
a
a
a
a
a
"}
(18,1,1) = {"
a
a
a
a
a
E
E
E
E
E
E
E
E
E
E
E
E
E
E
E
E
E
E
E
E
E
E
E
E
E
E
E
E
E
E
E
E
E
E
E
f
E
E
E
E
E
a
a
a
a
"}
(19,1,1) = {"
a
a
a
a
a
E
E
E
E
E
E
E
E
E
E
E
E
E
E
E
E
E
E
E
E
E
E
E
E
E
E
E
E
E
E
E
E
E
E
E
f
f
E
E
E
E
a
a
a
a
"}
(20,1,1) = {"
a
a
a
a
a
a
E
E
E
E
E
E
E
E
E
E
E
E
E
E
E
E
E
E
E
E
E
E
E
E
E
E
E
E
E
E
E
E
E
E
E
f
E
E
E
E
a
a
a
a
"}
(21,1,1) = {"
a
a
a
a
a
a
a
E
E
E
E
E
E
E
E
E
E
E
E
E
E
E
E
E
E
E
E
E
E
E
E
E
E
E
E
E
E
E
E
E
E
f
f
E
E
E
a
a
a
a
"}
(22,1,1) = {"
a
a
a
a
a
a
a
E
E
E
E
E
E
E
E
E
E
E
E
E
E
E
E
E
E
E
E
E
E
E
E
E
E
E
E
E
E
E
E
E
E
E
f
f
E
E
E
E
a
a
"}
(23,1,1) = {"
a
a
a
a
a
a
a
E
E
E
E
E
E
E
E
E
E
E
E
E
E
E
E
E
E
E
E
E
E
E
E
E
E
E
E
E
E
E
E
E
E
E
E
f
E
E
E
E
a
a
"}
(24,1,1) = {"
a
a
a
a
a
a
a
E
E
E
E
E
E
E
E
E
E
E
E
E
E
E
E
E
E
E
E
E
E
E
E
E
E
E
E
E
E
E
E
E
E
E
E
f
f
E
E
E
E
a
"}
(25,1,1) = {"
a
a
a
a
a
a
a
a
E
E
E
E
E
E
E
E
E
E
E
E
E
E
E
E
E
E
E
E
E
E
E
E
E
X
X
X
X
X
X
X
X
D
E
E
f
E
E
E
E
a
"}
(26,1,1) = {"
a
a
a
a
a
a
a
a
E
E
E
E
E
E
E
E
E
E
E
E
E
t
t
t
t
t
t
t
t
t
t
E
E
X
m
W
X
S
X
P
o
D
E
E
f
E
E
E
a
a
"}
(27,1,1) = {"
a
a
a
a
a
a
a
a
E
E
E
E
E
E
E
E
E
E
E
E
E
t
t
t
t
t
t
t
t
t
t
E
E
X
y
K
L
z
L
y
K
D
E
E
f
E
E
a
a
a
"}
(28,1,1) = {"
a
a
a
a
a
a
a
U
I
E
E
E
E
E
E
E
E
E
E
E
E
t
t
t
t
t
t
t
t
t
t
E
E
X
X
X
V
z
k
X
X
D
E
E
f
E
a
a
a
a
"}
(29,1,1) = {"
a
a
a
a
a
a
a
a
E
E
E
E
E
E
E
E
E
E
E
E
E
t
t
t
t
t
t
t
t
t
t
E
E
X
m
W
X
z
X
P
o
D
E
E
f
I
U
a
a
a
"}
(30,1,1) = {"
a
a
a
a
a
a
a
a
E
E
E
E
E
E
E
E
E
E
E
E
E
t
t
t
t
t
t
t
t
t
t
E
E
X
y
K
L
z
L
y
K
D
E
E
f
f
a
a
a
a
"}
(31,1,1) = {"
a
a
a
a
a
a
a
a
E
E
E
E
E
E
E
E
E
E
E
E
E
t
t
t
t
t
t
t
t
t
t
E
E
X
X
X
Q
z
G
X
X
D
E
E
f
f
a
a
a
a
"}
(32,1,1) = {"
a
a
a
a
a
a
a
E
E
E
E
E
E
E
E
E
E
E
E
E
E
t
t
t
t
t
t
t
t
t
t
E
E
X
m
W
X
z
X
P
o
D
E
E
f
r
a
a
a
a
"}
(33,1,1) = {"
a
a
a
a
a
a
a
E
E
E
E
E
E
E
E
E
E
E
E
E
E
t
t
t
t
t
t
t
t
t
t
E
E
X
y
K
L
z
L
y
K
D
E
E
f
f
a
a
a
a
"}
(34,1,1) = {"
a
a
a
a
a
a
a
a
E
E
E
E
E
E
E
E
E
E
E
E
E
t
t
t
t
t
t
t
t
t
t
E
E
X
X
X
M
z
l
X
X
D
E
E
f
f
a
a
a
a
"}
(35,1,1) = {"
a
a
a
a
a
a
a
a
E
E
E
E
E
E
E
E
E
E
E
E
E
E
E
E
E
E
E
E
E
E
E
E
E
D
m
W
X
z
X
P
o
D
E
E
f
f
a
a
a
a
"}
(36,1,1) = {"
a
a
a
a
a
a
a
a
a
E
E
E
E
E
E
E
E
E
E
E
E
E
E
E
E
E
I
E
E
E
E
E
E
D
y
K
L
S
L
y
K
D
E
E
f
f
a
a
a
a
"}
(37,1,1) = {"
a
a
a
a
a
a
a
a
a
E
E
E
E
E
E
E
E
E
E
E
E
E
E
E
E
a
U
a
a
E
E
E
E
D
D
D
D
D
D
D
D
D
E
E
E
f
a
a
a
a
"}
(38,1,1) = {"
a
a
a
a
a
a
a
a
a
E
E
E
E
E
E
E
E
E
E
E
E
E
E
a
a
a
a
a
a
a
a
E
E
E
E
E
E
E
E
E
E
E
E
E
a
a
a
a
a
a
"}
(39,1,1) = {"
a
a
a
a
a
a
a
a
a
a
a
E
E
E
E
E
E
E
E
E
E
E
E
a
a
a
a
a
a
a
a
a
E
E
E
E
E
E
E
E
E
E
E
a
a
a
a
a
a
a
"}
(40,1,1) = {"
a
a
a
a
a
a
a
a
a
a
a
a
E
E
E
E
E
E
E
E
E
E
E
a
a
a
a
a
a
a
a
a
a
a
a
E
E
E
E
E
E
E
a
a
a
a
a
a
a
a
"}
(41,1,1) = {"
a
a
a
a
a
a
a
a
a
a
a
a
a
a
a
E
E
E
E
E
a
a
a
a
a
a
a
a
a
a
a
a
a
a
a
a
E
E
E
E
E
E
a
a
a
a
a
a
a
a
"}
(42,1,1) = {"
a
a
a
a
a
a
a
a
a
a
a
a
a
a
a
a
E
E
E
a
a
a
a
a
a
a
a
a
a
a
a
a
a
a
a
a
a
E
E
E
E
a
a
a
a
a
a
a
a
a
"}
(43,1,1) = {"
a
a
a
a
a
a
a
a
a
a
a
a
a
a
a
a
a
a
a
a
a
a
a
a
a
a
a
a
a
a
a
a
a
a
a
a
a
a
a
a
a
a
a
a
a
a
a
a
a
a
"}
(44,1,1) = {"
a
a
a
a
a
a
a
a
a
a
a
a
a
a
a
a
a
a
a
a
a
a
a
a
a
a
a
a
a
a
a
a
a
a
a
a
a
a
a
a
a
a
a
a
a
a
a
a
a
a
"}
(45,1,1) = {"
a
a
a
a
a
a
a
a
a
a
a
a
a
a
a
a
a
a
a
a
a
a
a
a
a
a
a
a
a
a
a
a
a
a
a
a
a
a
a
a
a
a
a
a
a
a
a
a
a
a
"}
(46,1,1) = {"
a
a
a
a
a
a
a
a
a
a
a
a
a
a
a
a
a
a
a
a
a
a
a
a
a
a
a
a
a
a
a
a
a
a
a
a
a
a
a
a
a
a
a
a
a
a
a
a
a
a
"}
(47,1,1) = {"
a
a
a
a
a
a
a
a
a
a
a
a
a
a
a
a
a
a
a
a
a
a
a
a
a
a
a
a
a
a
a
a
a
a
a
a
a
a
a
a
a
a
a
a
a
a
a
a
a
a
"}
(48,1,1) = {"
a
a
a
a
a
a
a
a
a
a
a
a
a
a
a
a
a
a
a
a
a
a
a
a
a
a
a
a
a
a
a
a
a
a
a
a
a
a
a
a
a
a
a
a
a
a
a
a
a
a
"}
(49,1,1) = {"
a
a
a
a
a
a
a
a
a
a
a
a
a
a
a
a
a
a
a
a
a
a
a
a
a
a
a
a
a
a
a
a
a
a
a
a
a
a
a
a
a
a
a
a
a
a
a
a
a
a
"}
(50,1,1) = {"
a
a
a
a
a
a
a
a
a
a
a
a
a
a
a
a
a
a
a
a
a
a
a
a
a
a
a
a
a
a
a
a
a
a
a
a
a
a
a
a
a
a
a
a
a
a
a
a
a
a
"}
