//MAP CONVERTED BY dmm2tgm.py THIS HEADER COMMENT PREVENTS RECONVERSION, DO NOT REMOVE
"aE" = (
/obj/effect/turf_decal/trimline/dark/filled/warning,
/turf/open/floor/iron/large,
/area/template_noop)
"dM" = (
/obj/effect/decal/cleanable/blood/tracks{
	dir = 1
	},
/obj/effect/decal/cleanable/blood/bubblegum{
	icon_state = "armorblood"
	},
/turf/open/misc/asteroid,
/area/template_noop)
"eg" = (
/obj/effect/decal/cleanable/blood/tracks{
	dir = 1
	},
/obj/effect/decal/cleanable/blood/bubblegum{
	icon_state = "drip3"
	},
/turf/open/misc/asteroid,
/area/template_noop)
"er" = (
/obj/effect/turf_decal/trimline/dark/filled/warning{
	dir = 10
	},
/turf/open/floor/iron/large,
/area/template_noop)
"gf" = (
/obj/effect/turf_decal/trimline/dark/filled/warning{
	dir = 6
	},
/turf/open/floor/iron/large,
/area/template_noop)
"gG" = (
/obj/structure/table/reinforced,
/obj/item/paper/fluff/ruins/hobbystation/infofluff,
/turf/open/floor/iron/dark/textured_corner{
	dir = 4
	},
/area/ruin/space/has_grav/hobbystation/commons)
"gW" = (
/turf/closed/wall/r_wall,
/area/ruin/space/has_grav/hobbystation/commons)
"iQ" = (
/turf/closed/wall,
/area/template_noop)
"ja" = (
/obj/structure/table/reinforced,
/obj/item/paper/fluff/ruins/hobbystation/infofluff,
/obj/effect/decal/cleanable/dirt/dust,
/turf/open/floor/iron/dark/textured_corner,
/area/ruin/space/has_grav/hobbystation/commons)
"jq" = (
/obj/effect/decal/cleanable/dirt/dust,
/turf/open/floor/iron/dark/textured_corner{
	dir = 8
	},
/area/ruin/space/has_grav/hobbystation/commons)
"jH" = (
/obj/structure/table,
/obj/item/pizzabox{
	pixel_x = 3;
	pixel_y = 9
	},
/turf/open/floor/iron/cafeteria,
/area/template_noop)
"jY" = (
/turf/open/floor/iron/smooth_half,
/area/ruin/space/has_grav/hobbystation/commons)
"kt" = (
/obj/structure/table,
/obj/item/plate{
	pixel_y = 2
	},
/turf/open/floor/iron/cafeteria,
/area/template_noop)
"kY" = (
/obj/effect/decal/cleanable/blood/tracks{
	dir = 1
	},
/obj/effect/decal/cleanable/blood/bubblegum{
	icon_state = "drip1"
	},
/turf/open/misc/asteroid,
/area/template_noop)
"lp" = (
/obj/effect/decal/cleanable/blood/bubblegum{
	icon_state = "armorblood"
	},
/obj/effect/decal/cleanable/blood/bubblegum{
	icon_state = "armorblood"
	},
/turf/closed/mineral/random,
/area/template_noop)
"lq" = (
/obj/structure/mirror/directional{
	pixel_y = 30;
	pixel_x = -1
	},
/obj/structure/sink/directional/south,
/obj/effect/decal/cleanable/dirt/dust,
/turf/open/floor/iron/dark/textured_corner,
/area/ruin/space/has_grav/hobbystation/commons)
"lX" = (
/obj/structure/sign/poster/official/get_your_legs,
/turf/closed/wall,
/area/ruin/space/has_grav/hobbystation/commons)
"mC" = (
/obj/effect/decal/cleanable/blood/bubblegum{
	icon_state = "gib3-old"
	},
/turf/open/misc/asteroid,
/area/template_noop)
"mI" = (
/obj/structure/sign/poster/official/cleanliness,
/turf/closed/wall,
/area/ruin/space/has_grav/hobbystation/commons)
"nQ" = (
/obj/effect/decal/cleanable/blood,
/turf/open/misc/asteroid,
/area/template_noop)
"os" = (
/obj/structure/sign/poster/official/build,
/turf/closed/wall,
/area/ruin/space/has_grav/hobbystation/commons)
"oX" = (
/turf/open/floor/iron/dark/textured_corner{
	dir = 1
	},
/area/ruin/space/has_grav/hobbystation/commons)
"pn" = (
/obj/machinery/door/airlock/public/glass,
/turf/open/floor/iron/kitchen,
/area/template_noop)
"pR" = (
/obj/effect/decal/cleanable/blood/tracks{
	dir = 1
	},
/obj/effect/decal/cleanable/blood/tracks{
	dir = 1
	},
/obj/effect/decal/cleanable/blood/bubblegum{
	icon_state = "drip4"
	},
/turf/open/misc/asteroid,
/area/template_noop)
"qW" = (
/obj/structure/sink{
	dir = 1;
	pixel_y = -13
	},
/obj/structure/mirror{
	pixel_y = -29
	},
/turf/open/floor/iron/dark/textured_corner{
	dir = 4
	},
/area/ruin/space/has_grav/hobbystation/commons)
"qZ" = (
/obj/effect/turf_decal/trimline/dark/filled/warning{
	dir = 8
	},
/turf/open/floor/iron/large,
/area/template_noop)
"sx" = (
/obj/structure/lattice/catwalk,
/obj/structure/marker_beacon/indigo,
/turf/open/space/basic,
/area/template_noop)
"tH" = (
/obj/structure/chair/plastic{
	dir = 4
	},
/turf/open/floor/iron/cafeteria,
/area/template_noop)
"vz" = (
/turf/open/floor/iron/dark/textured_corner{
	dir = 8
	},
/area/ruin/space/has_grav/hobbystation/commons)
"wl" = (
/obj/effect/mob_spawn/corpse/human,
/obj/effect/decal/cleanable/blood/bubblegum{
	icon_state = "floor2"
	},
/turf/open/misc/asteroid,
/area/template_noop)
"xw" = (
/obj/structure/sign/nanotrasen,
/obj/structure/marker_beacon/indigo,
/turf/closed/wall,
/area/template_noop)
"xC" = (
/obj/structure/table,
/obj/item/storage/dice{
	pixel_y = 8;
	pixel_x = 11
	},
/turf/open/floor/iron/cafeteria,
/area/template_noop)
"yv" = (
/obj/structure/table,
/obj/item/paper_bin{
	pixel_y = 6
	},
/turf/open/floor/iron/cafeteria,
/area/template_noop)
"BX" = (
/obj/effect/decal/cleanable/blood/tracks{
	dir = 10
	},
/turf/open/misc/asteroid,
/area/template_noop)
"CV" = (
/obj/structure/table,
/obj/item/toy/cards/deck{
	pixel_y = 7
	},
/turf/open/floor/iron/cafeteria,
/area/template_noop)
"DK" = (
/obj/structure/table/reinforced,
/obj/item/paper/fluff/ruins/hobbystation/infofluff,
/turf/open/floor/iron/dark/textured_corner,
/area/ruin/space/has_grav/hobbystation/commons)
"Eg" = (
/obj/structure/chair/plastic{
	dir = 8
	},
/turf/open/floor/iron/cafeteria,
/area/template_noop)
"Fk" = (
/obj/effect/turf_decal/trimline/dark/filled/warning{
	dir = 4
	},
/turf/open/floor/iron/large,
/area/template_noop)
"GA" = (
/turf/open/floor/iron/cafeteria,
/area/template_noop)
"HF" = (
/obj/effect/decal/cleanable/blood/tracks{
	dir = 8
	},
/turf/open/misc/asteroid,
/area/template_noop)
"HJ" = (
/obj/structure/chair/plastic,
/turf/open/floor/iron/cafeteria,
/area/template_noop)
"Ic" = (
/obj/structure/sign/poster/official/work_for_a_future,
/turf/closed/wall,
/area/ruin/space/has_grav/hobbystation/commons)
"KJ" = (
/turf/closed/wall/r_wall,
/area/template_noop)
"KM" = (
/turf/open/floor/iron/kitchen,
/area/template_noop)
"Lg" = (
/turf/open/floor/iron/smooth,
/area/ruin/space/has_grav/hobbystation/commons)
"LY" = (
/turf/closed/wall,
/area/ruin/space/has_grav/hobbystation/commons)
"Nb" = (
/obj/structure/table/reinforced,
/obj/item/plate,
/turf/open/floor/iron/cafeteria,
/area/template_noop)
"Nk" = (
/obj/effect/decal/cleanable/blood/tracks{
	dir = 5
	},
/turf/open/misc/asteroid,
/area/template_noop)
"OG" = (
/obj/structure/table,
/turf/open/floor/iron/cafeteria,
/area/template_noop)
"SA" = (
/obj/effect/decal/cleanable/dirt/dust,
/turf/open/floor/iron/dark/side{
	dir = 4
	},
/area/ruin/space/has_grav/hobbystation/commons)
"SG" = (
/obj/structure/sign/poster/official/help_others,
/turf/closed/wall,
/area/ruin/space/has_grav/hobbystation/commons)
"SR" = (
/obj/structure/sign/poster/official/here_for_your_safety,
/turf/closed/wall,
/area/ruin/space/has_grav/hobbystation/commons)
"Tb" = (
/obj/effect/decal/cleanable/dirt/dust,
/turf/open/floor/iron/smooth_half,
/area/ruin/space/has_grav/hobbystation/commons)
"UK" = (
/turf/closed/mineral/random,
/area/template_noop)
"US" = (
/obj/effect/decal/cleanable/blood/tracks{
	dir = 1
	},
/turf/open/misc/asteroid,
/area/template_noop)
"Vf" = (
/obj/structure/billboard/nanotrasen/defaced,
/turf/open/misc/asteroid,
/area/template_noop)
"WV" = (
/obj/structure/chair/plastic{
	dir = 1
	},
/turf/open/floor/iron/cafeteria,
/area/template_noop)
"Xz" = (
/turf/template_noop,
/area/template_noop)
"XF" = (
/obj/structure/table/reinforced,
/obj/item/paper/fluff/ruins/hobbystation/infofluff,
/obj/effect/decal/cleanable/dirt/dust,
/turf/open/floor/iron/dark/textured_corner{
	dir = 4
	},
/area/ruin/space/has_grav/hobbystation/commons)
"XN" = (
/obj/structure/sink{
	dir = 1;
	pixel_y = -13
	},
/obj/structure/mirror{
	pixel_y = -29
	},
/obj/effect/decal/cleanable/dirt/dust,
/turf/open/floor/iron/dark/textured_corner{
	dir = 4
	},
/area/ruin/space/has_grav/hobbystation/commons)
"XY" = (
/obj/machinery/door/airlock/centcom,
/turf/open/floor/plating,
/area/ruin/space/has_grav/hobbystation/commons)
"Yj" = (
/obj/effect/decal/cleanable/dirt/dust,
/turf/open/floor/iron/dark/textured_corner{
	dir = 1
	},
/area/ruin/space/has_grav/hobbystation/commons)
"YH" = (
/turf/open/floor/iron/kitchen/small,
/area/template_noop)
"YJ" = (
/turf/open/misc/asteroid,
/area/template_noop)
"ZH" = (
/turf/open/floor/engine{
	name = "Holodeck Projector Floor"
	},
/area/template_noop)

(1,1,1) = {"
Xz
Xz
Xz
Xz
Xz
Xz
Xz
Xz
Xz
Xz
Xz
Xz
Xz
Xz
Xz
Xz
Xz
Xz
Xz
Xz
Xz
Xz
Xz
Xz
Xz
Xz
Xz
Xz
Xz
Xz
Xz
Xz
Xz
Xz
Xz
Xz
Xz
Xz
Xz
Xz
Xz
Xz
Xz
Xz
Xz
Xz
Xz
Xz
Xz
Xz
"}
(2,1,1) = {"
Xz
Xz
Xz
Xz
Xz
Xz
Xz
Xz
Xz
Xz
Xz
Xz
Xz
Xz
Xz
Xz
Xz
Xz
Xz
Xz
Xz
Xz
Xz
Xz
Xz
Xz
Xz
Xz
Xz
Xz
Xz
Xz
Xz
Xz
Xz
Xz
Xz
Xz
Xz
Xz
Xz
Xz
Xz
Xz
Xz
Xz
Xz
Xz
Xz
Xz
"}
(3,1,1) = {"
Xz
Xz
Xz
Xz
Xz
Xz
Xz
Xz
Xz
Xz
Xz
Xz
Xz
Xz
Xz
Xz
Xz
Xz
Xz
Xz
Xz
Xz
Xz
Xz
Xz
Xz
Xz
Xz
Xz
Xz
Xz
Xz
Xz
Xz
Xz
Xz
Xz
Xz
Xz
Xz
Xz
Xz
Xz
Xz
Xz
Xz
Xz
Xz
Xz
Xz
"}
(4,1,1) = {"
Xz
Xz
Xz
Xz
Xz
Xz
Xz
Xz
Xz
Xz
Xz
Xz
Xz
Xz
Xz
Xz
Xz
Xz
Xz
Xz
Xz
Xz
Xz
Xz
sx
Xz
Xz
Xz
Xz
Xz
Xz
Xz
Xz
Xz
Xz
Xz
Xz
Xz
Xz
Xz
Xz
Xz
Xz
Xz
Xz
Xz
Xz
Xz
Xz
Xz
"}
(5,1,1) = {"
Xz
Xz
Xz
Xz
Xz
Xz
Xz
Xz
Xz
Xz
Xz
Xz
Xz
Xz
Xz
Xz
Xz
Xz
Xz
Xz
Xz
Xz
UK
UK
xw
UK
UK
Xz
Xz
Xz
Xz
Xz
Xz
Xz
Xz
Xz
Xz
Xz
Xz
Xz
Xz
Xz
Xz
Xz
Xz
Xz
Xz
Xz
Xz
Xz
"}
(6,1,1) = {"
Xz
Xz
Xz
Xz
Xz
Xz
Xz
Xz
Xz
Xz
Xz
Xz
Xz
Xz
Xz
UK
UK
UK
UK
UK
UK
UK
UK
UK
UK
UK
UK
UK
Nk
kY
US
pR
eg
dM
BX
YJ
UK
UK
Xz
Xz
Xz
Xz
Xz
Xz
Xz
Xz
Xz
Xz
Xz
Xz
"}
(7,1,1) = {"
Xz
Xz
Xz
Xz
Xz
Xz
Xz
Xz
Xz
Xz
Xz
Xz
UK
UK
UK
UK
UK
UK
UK
UK
UK
UK
UK
UK
UK
UK
UK
UK
UK
UK
nQ
YJ
YJ
YJ
HF
UK
UK
UK
UK
Xz
Xz
Xz
Xz
Xz
Xz
Xz
Xz
Xz
Xz
Xz
"}
(8,1,1) = {"
Xz
Xz
Xz
Xz
Xz
Xz
Xz
Xz
Xz
Xz
Xz
Xz
UK
UK
UK
UK
UK
UK
UK
UK
UK
UK
UK
UK
UK
UK
UK
UK
lp
UK
UK
UK
UK
UK
HF
UK
UK
UK
UK
UK
UK
Xz
Xz
Xz
Xz
Xz
Xz
Xz
Xz
Xz
"}
(9,1,1) = {"
Xz
Xz
Xz
Xz
Xz
Xz
Xz
Xz
Xz
Xz
UK
UK
UK
UK
UK
UK
UK
UK
UK
UK
UK
UK
UK
UK
UK
UK
UK
UK
UK
UK
UK
UK
UK
UK
HF
UK
UK
UK
UK
UK
UK
Xz
Xz
Xz
Xz
Xz
Xz
Xz
Xz
Xz
"}
(10,1,1) = {"
Xz
Xz
Xz
Xz
Xz
Xz
Xz
UK
UK
UK
UK
UK
UK
UK
UK
UK
UK
UK
UK
UK
UK
UK
UK
UK
UK
UK
UK
UK
UK
UK
UK
UK
UK
UK
wl
YJ
YJ
mC
YJ
YJ
YJ
YJ
YJ
Xz
Xz
Xz
Xz
Xz
Xz
Xz
"}
(11,1,1) = {"
Xz
Xz
Xz
Xz
Xz
UK
UK
UK
UK
UK
UK
UK
UK
UK
UK
UK
UK
UK
UK
UK
UK
UK
UK
UK
UK
UK
UK
UK
UK
UK
UK
UK
UK
UK
UK
UK
UK
UK
UK
UK
YJ
YJ
YJ
Xz
Xz
Xz
Xz
Xz
Xz
Xz
"}
(12,1,1) = {"
Xz
Xz
Xz
Xz
Xz
UK
UK
UK
UK
UK
UK
UK
UK
UK
UK
UK
UK
UK
UK
UK
UK
UK
UK
KJ
KJ
KJ
KJ
KJ
KJ
KJ
KJ
KJ
KJ
KJ
KJ
KJ
KJ
KJ
KJ
UK
YJ
YJ
Xz
Xz
Xz
Xz
Xz
Xz
Xz
Xz
"}
(13,1,1) = {"
Xz
Xz
Xz
Xz
UK
UK
UK
UK
UK
UK
UK
UK
UK
UK
UK
UK
UK
UK
UK
UK
UK
UK
UK
KJ
KM
KM
KM
KM
iQ
qZ
qZ
qZ
qZ
qZ
qZ
qZ
qZ
er
KJ
UK
YJ
YJ
Xz
Xz
Xz
Xz
Xz
Xz
Xz
Xz
"}
(14,1,1) = {"
Xz
Xz
Xz
Xz
UK
UK
UK
UK
UK
UK
UK
UK
UK
UK
UK
UK
UK
UK
UK
UK
UK
UK
UK
KJ
KM
YH
YH
KM
iQ
GA
GA
GA
GA
GA
GA
GA
GA
aE
KJ
UK
YJ
YJ
YJ
YJ
Xz
Xz
Xz
Xz
Xz
Xz
"}
(15,1,1) = {"
Xz
Xz
Xz
Xz
UK
UK
UK
UK
UK
UK
UK
UK
UK
UK
UK
UK
UK
UK
UK
UK
UK
UK
UK
KJ
KM
YH
YH
KM
Nb
GA
GA
tH
GA
GA
GA
tH
GA
aE
KJ
UK
YJ
YJ
YJ
YJ
Xz
Xz
Xz
Xz
Xz
Xz
"}
(16,1,1) = {"
Xz
Xz
Xz
Xz
UK
UK
UK
UK
UK
UK
UK
UK
UK
UK
UK
UK
UK
UK
UK
UK
UK
UK
UK
KJ
KM
YH
YH
KM
Nb
GA
HJ
OG
WV
GA
HJ
yv
WV
aE
KJ
UK
YJ
UK
UK
UK
Xz
Xz
Xz
Xz
Xz
Xz
"}
(17,1,1) = {"
Xz
Xz
Xz
Xz
UK
UK
UK
UK
UK
UK
UK
UK
UK
UK
UK
UK
UK
UK
UK
UK
UK
UK
UK
KJ
KM
YH
YH
KM
Nb
GA
HJ
kt
WV
GA
HJ
xC
WV
aE
KJ
UK
YJ
UK
UK
UK
Xz
Xz
Xz
Xz
Xz
Xz
"}
(18,1,1) = {"
Xz
Xz
Xz
Xz
Xz
UK
UK
UK
UK
UK
UK
UK
UK
UK
UK
UK
UK
UK
UK
UK
UK
UK
UK
KJ
KM
YH
YH
KM
Nb
GA
HJ
OG
WV
GA
HJ
OG
WV
aE
KJ
UK
YJ
UK
UK
UK
UK
UK
Xz
Xz
Xz
Xz
"}
(19,1,1) = {"
Xz
Xz
Xz
Xz
Xz
UK
UK
UK
UK
UK
UK
UK
UK
UK
UK
UK
UK
UK
UK
UK
UK
UK
UK
KJ
KM
YH
YH
KM
Nb
GA
HJ
jH
WV
GA
HJ
OG
WV
aE
KJ
UK
YJ
YJ
UK
UK
UK
UK
Xz
Xz
Xz
Xz
"}
(20,1,1) = {"
Xz
Xz
Xz
Xz
Xz
Xz
UK
UK
UK
UK
UK
UK
UK
UK
UK
UK
UK
UK
UK
UK
UK
UK
UK
KJ
KM
YH
YH
KM
Nb
GA
HJ
OG
WV
GA
HJ
CV
WV
aE
KJ
UK
UK
YJ
UK
UK
UK
UK
Xz
Xz
Xz
Xz
"}
(21,1,1) = {"
Xz
Xz
Xz
Xz
Xz
Xz
Xz
UK
UK
UK
UK
UK
UK
UK
UK
UK
UK
UK
UK
UK
UK
UK
UK
KJ
KM
YH
YH
KM
Nb
GA
HJ
OG
WV
GA
HJ
OG
WV
aE
KJ
UK
UK
YJ
YJ
UK
UK
UK
Xz
Xz
Xz
Xz
"}
(22,1,1) = {"
Xz
Xz
Xz
Xz
Xz
Xz
Xz
UK
UK
UK
UK
UK
UK
UK
UK
UK
UK
UK
UK
UK
UK
UK
UK
KJ
KM
YH
YH
KM
Nb
GA
GA
Eg
GA
GA
GA
Eg
GA
aE
KJ
UK
UK
UK
YJ
YJ
UK
UK
UK
UK
Xz
Xz
"}
(23,1,1) = {"
Xz
Xz
Xz
Xz
Xz
Xz
Xz
UK
UK
UK
UK
UK
UK
UK
UK
UK
UK
UK
UK
UK
UK
UK
UK
KJ
KM
YH
YH
KM
iQ
GA
GA
GA
GA
GA
GA
GA
GA
aE
KJ
UK
UK
UK
UK
YJ
UK
UK
UK
UK
Xz
Xz
"}
(24,1,1) = {"
Xz
Xz
Xz
Xz
Xz
Xz
Xz
UK
UK
UK
UK
UK
UK
UK
UK
UK
UK
UK
UK
UK
UK
UK
UK
KJ
KM
KM
KM
KM
pn
Fk
Fk
Fk
Fk
Fk
Fk
Fk
Fk
gf
KJ
UK
UK
UK
UK
YJ
YJ
UK
UK
UK
UK
Xz
"}
(25,1,1) = {"
Xz
Xz
Xz
Xz
Xz
Xz
Xz
Xz
UK
UK
UK
UK
UK
UK
UK
UK
UK
UK
UK
UK
UK
UK
UK
iQ
iQ
iQ
iQ
iQ
iQ
iQ
iQ
iQ
iQ
LY
LY
LY
LY
SA
LY
LY
LY
gW
UK
UK
YJ
UK
UK
UK
UK
Xz
"}
(26,1,1) = {"
Xz
Xz
Xz
Xz
Xz
Xz
Xz
Xz
UK
UK
UK
UK
UK
UK
UK
UK
UK
UK
UK
UK
UK
ZH
ZH
ZH
ZH
ZH
ZH
ZH
ZH
ZH
ZH
UK
UK
LY
ja
qW
LY
Lg
LY
lq
XF
gW
UK
UK
YJ
UK
UK
UK
Xz
Xz
"}
(27,1,1) = {"
Xz
Xz
Xz
Xz
Xz
Xz
Xz
Xz
UK
UK
UK
UK
UK
UK
UK
UK
UK
UK
UK
UK
UK
ZH
ZH
ZH
ZH
ZH
ZH
ZH
ZH
ZH
ZH
UK
UK
LY
vz
Yj
XY
Tb
XY
vz
Yj
gW
UK
UK
YJ
UK
UK
Xz
Xz
Xz
"}
(28,1,1) = {"
Xz
Xz
Xz
Xz
Xz
Xz
Xz
sx
xw
UK
UK
UK
UK
UK
UK
UK
UK
UK
UK
UK
UK
ZH
ZH
ZH
ZH
ZH
ZH
ZH
ZH
ZH
ZH
UK
UK
LY
LY
LY
Ic
Tb
SG
LY
LY
gW
UK
UK
YJ
UK
Xz
Xz
Xz
Xz
"}
(29,1,1) = {"
Xz
Xz
Xz
Xz
Xz
Xz
Xz
Xz
UK
UK
UK
UK
UK
UK
UK
UK
UK
UK
UK
UK
UK
ZH
ZH
ZH
ZH
ZH
ZH
ZH
ZH
ZH
ZH
UK
UK
LY
ja
XN
LY
jY
LY
lq
XF
gW
UK
UK
YJ
xw
sx
Xz
Xz
Xz
"}
(30,1,1) = {"
Xz
Xz
Xz
Xz
Xz
Xz
Xz
Xz
UK
UK
UK
UK
UK
UK
UK
UK
UK
UK
UK
UK
UK
ZH
ZH
ZH
ZH
ZH
ZH
ZH
ZH
ZH
ZH
UK
UK
LY
vz
Yj
XY
Tb
XY
vz
Yj
gW
UK
UK
YJ
YJ
Xz
Xz
Xz
Xz
"}
(31,1,1) = {"
Xz
Xz
Xz
Xz
Xz
Xz
Xz
Xz
UK
UK
UK
UK
UK
UK
UK
UK
UK
UK
UK
UK
UK
ZH
ZH
ZH
ZH
ZH
ZH
ZH
ZH
ZH
ZH
UK
UK
LY
LY
LY
SR
Tb
lX
LY
LY
gW
UK
UK
YJ
YJ
Xz
Xz
Xz
Xz
"}
(32,1,1) = {"
Xz
Xz
Xz
Xz
Xz
Xz
Xz
UK
UK
UK
UK
UK
UK
UK
UK
UK
UK
UK
UK
UK
UK
ZH
ZH
ZH
ZH
ZH
ZH
ZH
ZH
ZH
ZH
UK
UK
LY
DK
XN
LY
Tb
LY
lq
gG
gW
UK
UK
YJ
Vf
Xz
Xz
Xz
Xz
"}
(33,1,1) = {"
Xz
Xz
Xz
Xz
Xz
Xz
Xz
UK
UK
UK
UK
UK
UK
UK
UK
UK
UK
UK
UK
UK
UK
ZH
ZH
ZH
ZH
ZH
ZH
ZH
ZH
ZH
ZH
UK
UK
LY
vz
Yj
XY
jY
XY
vz
oX
gW
UK
UK
YJ
YJ
Xz
Xz
Xz
Xz
"}
(34,1,1) = {"
Xz
Xz
Xz
Xz
Xz
Xz
Xz
Xz
UK
UK
UK
UK
UK
UK
UK
UK
UK
UK
UK
UK
UK
ZH
ZH
ZH
ZH
ZH
ZH
ZH
ZH
ZH
ZH
UK
UK
LY
LY
LY
os
Tb
mI
LY
LY
gW
UK
UK
YJ
YJ
Xz
Xz
Xz
Xz
"}
(35,1,1) = {"
Xz
Xz
Xz
Xz
Xz
Xz
Xz
Xz
UK
UK
UK
UK
UK
UK
UK
UK
UK
UK
UK
UK
UK
UK
UK
UK
UK
UK
UK
UK
UK
UK
UK
UK
UK
gW
ja
XN
LY
Tb
LY
lq
gG
gW
UK
UK
YJ
YJ
Xz
Xz
Xz
Xz
"}
(36,1,1) = {"
Xz
Xz
Xz
Xz
Xz
Xz
Xz
Xz
Xz
UK
UK
UK
UK
UK
UK
UK
UK
UK
UK
UK
UK
UK
UK
UK
UK
UK
xw
UK
UK
UK
UK
UK
UK
gW
jq
oX
XY
Lg
XY
jq
Yj
gW
UK
UK
YJ
YJ
Xz
Xz
Xz
Xz
"}
(37,1,1) = {"
Xz
Xz
Xz
Xz
Xz
Xz
Xz
Xz
Xz
UK
UK
UK
UK
UK
UK
UK
UK
UK
UK
UK
UK
UK
UK
UK
UK
Xz
sx
Xz
Xz
UK
UK
UK
UK
gW
gW
gW
gW
gW
gW
gW
gW
gW
UK
UK
UK
YJ
Xz
Xz
Xz
Xz
"}
(38,1,1) = {"
Xz
Xz
Xz
Xz
Xz
Xz
Xz
Xz
Xz
UK
UK
UK
UK
UK
UK
UK
UK
UK
UK
UK
UK
UK
UK
Xz
Xz
Xz
Xz
Xz
Xz
Xz
Xz
UK
UK
UK
UK
UK
UK
UK
UK
UK
UK
UK
UK
UK
Xz
Xz
Xz
Xz
Xz
Xz
"}
(39,1,1) = {"
Xz
Xz
Xz
Xz
Xz
Xz
Xz
Xz
Xz
Xz
Xz
UK
UK
UK
UK
UK
UK
UK
UK
UK
UK
UK
UK
Xz
Xz
Xz
Xz
Xz
Xz
Xz
Xz
Xz
UK
UK
UK
UK
UK
UK
UK
UK
UK
UK
UK
Xz
Xz
Xz
Xz
Xz
Xz
Xz
"}
(40,1,1) = {"
Xz
Xz
Xz
Xz
Xz
Xz
Xz
Xz
Xz
Xz
Xz
Xz
UK
UK
UK
UK
UK
UK
UK
UK
UK
UK
UK
Xz
Xz
Xz
Xz
Xz
Xz
Xz
Xz
Xz
Xz
Xz
Xz
UK
UK
UK
UK
UK
UK
UK
Xz
Xz
Xz
Xz
Xz
Xz
Xz
Xz
"}
(41,1,1) = {"
Xz
Xz
Xz
Xz
Xz
Xz
Xz
Xz
Xz
Xz
Xz
Xz
Xz
Xz
Xz
UK
UK
UK
UK
UK
Xz
Xz
Xz
Xz
Xz
Xz
Xz
Xz
Xz
Xz
Xz
Xz
Xz
Xz
Xz
Xz
UK
UK
UK
UK
UK
UK
Xz
Xz
Xz
Xz
Xz
Xz
Xz
Xz
"}
(42,1,1) = {"
Xz
Xz
Xz
Xz
Xz
Xz
Xz
Xz
Xz
Xz
Xz
Xz
Xz
Xz
Xz
Xz
UK
UK
UK
Xz
Xz
Xz
Xz
Xz
Xz
Xz
Xz
Xz
Xz
Xz
Xz
Xz
Xz
Xz
Xz
Xz
Xz
UK
UK
UK
UK
Xz
Xz
Xz
Xz
Xz
Xz
Xz
Xz
Xz
"}
(43,1,1) = {"
Xz
Xz
Xz
Xz
Xz
Xz
Xz
Xz
Xz
Xz
Xz
Xz
Xz
Xz
Xz
Xz
Xz
Xz
Xz
Xz
Xz
Xz
Xz
Xz
Xz
Xz
Xz
Xz
Xz
Xz
Xz
Xz
Xz
Xz
Xz
Xz
Xz
Xz
Xz
Xz
Xz
Xz
Xz
Xz
Xz
Xz
Xz
Xz
Xz
Xz
"}
(44,1,1) = {"
Xz
Xz
Xz
Xz
Xz
Xz
Xz
Xz
Xz
Xz
Xz
Xz
Xz
Xz
Xz
Xz
Xz
Xz
Xz
Xz
Xz
Xz
Xz
Xz
Xz
Xz
Xz
Xz
Xz
Xz
Xz
Xz
Xz
Xz
Xz
Xz
Xz
Xz
Xz
Xz
Xz
Xz
Xz
Xz
Xz
Xz
Xz
Xz
Xz
Xz
"}
(45,1,1) = {"
Xz
Xz
Xz
Xz
Xz
Xz
Xz
Xz
Xz
Xz
Xz
Xz
Xz
Xz
Xz
Xz
Xz
Xz
Xz
Xz
Xz
Xz
Xz
Xz
Xz
Xz
Xz
Xz
Xz
Xz
Xz
Xz
Xz
Xz
Xz
Xz
Xz
Xz
Xz
Xz
Xz
Xz
Xz
Xz
Xz
Xz
Xz
Xz
Xz
Xz
"}
(46,1,1) = {"
Xz
Xz
Xz
Xz
Xz
Xz
Xz
Xz
Xz
Xz
Xz
Xz
Xz
Xz
Xz
Xz
Xz
Xz
Xz
Xz
Xz
Xz
Xz
Xz
Xz
Xz
Xz
Xz
Xz
Xz
Xz
Xz
Xz
Xz
Xz
Xz
Xz
Xz
Xz
Xz
Xz
Xz
Xz
Xz
Xz
Xz
Xz
Xz
Xz
Xz
"}
(47,1,1) = {"
Xz
Xz
Xz
Xz
Xz
Xz
Xz
Xz
Xz
Xz
Xz
Xz
Xz
Xz
Xz
Xz
Xz
Xz
Xz
Xz
Xz
Xz
Xz
Xz
Xz
Xz
Xz
Xz
Xz
Xz
Xz
Xz
Xz
Xz
Xz
Xz
Xz
Xz
Xz
Xz
Xz
Xz
Xz
Xz
Xz
Xz
Xz
Xz
Xz
Xz
"}
(48,1,1) = {"
Xz
Xz
Xz
Xz
Xz
Xz
Xz
Xz
Xz
Xz
Xz
Xz
Xz
Xz
Xz
Xz
Xz
Xz
Xz
Xz
Xz
Xz
Xz
Xz
Xz
Xz
Xz
Xz
Xz
Xz
Xz
Xz
Xz
Xz
Xz
Xz
Xz
Xz
Xz
Xz
Xz
Xz
Xz
Xz
Xz
Xz
Xz
Xz
Xz
Xz
"}
(49,1,1) = {"
Xz
Xz
Xz
Xz
Xz
Xz
Xz
Xz
Xz
Xz
Xz
Xz
Xz
Xz
Xz
Xz
Xz
Xz
Xz
Xz
Xz
Xz
Xz
Xz
Xz
Xz
Xz
Xz
Xz
Xz
Xz
Xz
Xz
Xz
Xz
Xz
Xz
Xz
Xz
Xz
Xz
Xz
Xz
Xz
Xz
Xz
Xz
Xz
Xz
Xz
"}
(50,1,1) = {"
Xz
Xz
Xz
Xz
Xz
Xz
Xz
Xz
Xz
Xz
Xz
Xz
Xz
Xz
Xz
Xz
Xz
Xz
Xz
Xz
Xz
Xz
Xz
Xz
Xz
Xz
Xz
Xz
Xz
Xz
Xz
Xz
Xz
Xz
Xz
Xz
Xz
Xz
Xz
Xz
Xz
Xz
Xz
Xz
Xz
Xz
Xz
Xz
Xz
Xz
"}
